Name	Family	Type
15mer_SAT	Satellite	Satellite
MARINA	TcMar-Mariner	DNA
193XP_SAT	Satellite	Satellite
260bp_SAT	1pt688	Satellite
353bp_SAT	1pt688	Satellite
356bp_SAT	1pt688	Satellite
359bp_SAT	1pt688	Satellite
360bp_SAT	1pt688	Satellite
3L-TAS_SAT	Satellite	Satellite
500U_SAT	Satellite	Satellite
585-XAS_SAT	Satellite	Satellite
90U_SAT	Satellite	Satellite
ACCORD_I	Gypsy	LTR
ACCORD_LTR	Gypsy	LTR
ACCORD2_I	Gypsy	LTR
ACCORD2_LTR	Gypsy	LTR
ACCORD	Gypsy	LTR
ACCORD2	Gypsy	LTR
AT_rich	Low_complexity	Low_complexity
AY1_DH	Other	Other
Baggins1	LOA	Non-LTR_retrotransposon
BARI_DM	TcMar-Tc1	DNA
BARI1	TcMar-Tc1	DNA
BATUMI_I	Pao	LTR
BATUMI_LTR	Pao	LTR
BATUMI	Pao	LTR
BEL_I	Pao	LTR
BEL	Pao	LTR
BEL_LTR	Pao	LTR
BEL-1_DAn-I	Pao	LTR
BEL-1_DAn-LTR	Pao	LTR
BEL-1_DBi-I	Pao	LTR
BEL-1_DBi-LTR	Pao	LTR
BEL-1_DBp-I	Pao	LTR
BEL-1_DBp-LTR	Pao	LTR
BEL-1_DEl-I	Pao	LTR
BEL-1_DEl-LTR	Pao	LTR
BEL-1_DEre-I	Pao	LTR
BEL-1_DEre-LTR	Pao	LTR
BEL-1_Deu-I	Pao	LTR
BEL-1_Deu-LTR	Pao	LTR
BEL-1_DFi-I	Pao	LTR
BEL-1_DFi-LTR	Pao	LTR
BEL-1_DGri-I	Pao	LTR
BEL-1_DGri-LTR	Pao	LTR
BEL-1_DKi-I	Pao	LTR
BEL-1_DKi-LTR	Pao	LTR
BEL-1_DPer-I	Pao	LTR
BEL-1_DPer-LTR	Pao	LTR
BEL-1_DRh-I	Pao	LTR
BEL-1_DRh-LTR	Pao	LTR
BEL-1_DTa-I	Pao	LTR
BEL-1_DTa-LTR	Pao	LTR
BEL-1_DVir-I	Pao	LTR
BEL-1_DVir-LTR	Pao	LTR
BEL-1_DWil-I	Pao	LTR
BEL-1_DWil-LTR	Pao	LTR
BEL-10_DAn-I	Pao	LTR
BEL-10_DAn-LTR	Pao	LTR
BEL-10_DBp-I	Pao	LTR
BEL-10_DBp-LTR	Pao	LTR
BEL-10_DEl-I	Pao	LTR
BEL-10_DTa-I	Pao	LTR
BEL-10_DTa-LTR	Pao	LTR
BEL-10_DWil-I	Pao	LTR
BEL-10_DWil-LTR	Pao	LTR
BEL-11_DAn-I	Pao	LTR
BEL-11_DAn-LTR	Pao	LTR
BEL-11_DBp-I	Pao	LTR
BEL-11_DBp-LTR	Pao	LTR
BEL-11_DEl-I	Pao	LTR
BEL-11_DTa-I	Pao	LTR
BEL-11_DTa-LTR	Pao	LTR
BEL-11_DWil-I	Pao	LTR
BEL-11_DWil-LTR	Pao	LTR
BEL-12_DAn-I	Pao	LTR
BEL-12_DAn-LTR	Pao	LTR
BEL-12_DBp-I	Pao	LTR
BEL-12_DBp-LTR	Pao	LTR
BEL-12_DEl-I	Pao	LTR
BEL-12_DTa-I	Pao	LTR
BEL-12_DTa-LTR	Pao	LTR
BEL-12_DWil-I	Pao	LTR
BEL-12_DWil-LTR	Pao	LTR
BEL-13_DAn-I	Pao	LTR
BEL-13_DAn-LTR	Pao	LTR
BEL-13_DEl-I	Pao	LTR
BEL-13_DP-I	Pao	LTR
BEL-13_DP-LTR	Pao	LTR
BEL-13_DTa-I	Pao	LTR
BEL-13_DTa-LTR	Pao	LTR
BEL-13_DWil-I	Pao	LTR
BEL-13_DWil-LTR	Pao	LTR
BEL-14_DAn-I	Pao	LTR
BEL-14_DAn-LTR	Pao	LTR
BEL-14_DEl-I	Pao	LTR
BEL-14_DP-I	Pao	LTR
BEL-14_DP-LTR	Pao	LTR
BEL-14_DTa-I	Pao	LTR
BEL-14_DTa-LTR	Pao	LTR
BEL-14_DWil-I	Pao	LTR
BEL-14_DWil-LTR	Pao	LTR
BEL-15_DAn-I	Pao	LTR
BEL-15_DAn-LTR	Pao	LTR
BEL-15_DEl-I	Pao	LTR
BEL-15_DP-I	Pao	LTR
BEL-15_DP-LTR	Pao	LTR
BEL-15_DTa-I	Pao	LTR
BEL-15_DTa-LTR	Pao	LTR
BEL-15_DWil-I	Pao	LTR
BEL-15_DWil-LTR	Pao	LTR
BEL-16_DAn-I	Pao	LTR
BEL-16_DAn-LTR	Pao	LTR
BEL-16_DEl-I	Pao	LTR
BEL-16_DEl-LTR	Pao	LTR
BEL-16_DTa-I	Pao	LTR
BEL-16_DTa-LTR	Pao	LTR
BEL-16_DWil-I	Pao	LTR
BEL-16_DWil-LTR	Pao	LTR
BEL-17_DAn-I	Pao	LTR
BEL-17_DAn-LTR	Pao	LTR
BEL-17_DEl-I	Pao	LTR
BEL-17_DEl-LTR	Pao	LTR
BEL-17_DTa-I	Pao	LTR
BEL-17_DTa-LTR	Pao	LTR
BEL-17_DWil-LTR	Pao	LTR
BEL-18_DAn-I	Pao	LTR
BEL-18_DAn-LTR	Pao	LTR
BEL-18_DEl-I	Pao	LTR
BEL-18_DTa-I	Pao	LTR
BEL-18_DTa-LTR	Pao	LTR
BEL-18_DWil-I	Pao	LTR
BEL-18_DWil-LTR	Pao	LTR
BEL-19_DAn-I	Pao	LTR
BEL-19_DAn-LTR	Pao	LTR
BEL-19_DTa-I	Pao	LTR
BEL-19_DTa-LTR	Pao	LTR
BEL-19_DWil-I	Pao	LTR
BEL-19_DWil-LTR	Pao	LTR
BEL-2_DAn-I	Pao	LTR
BEL-2_DAn-LTR	Pao	LTR
BEL-2_DBi-I	Pao	LTR
BEL-2_DBi-LTR	Pao	LTR
BEL-2_DBp-I	Pao	LTR
BEL-2_DBp-LTR	Pao	LTR
BEL-2_DEl-I	Pao	LTR
BEL-2_DEl-LTR	Pao	LTR
BEL-2_Deu-I	Pao	LTR
BEL-2_Deu-LTR	Pao	LTR
BEL-2_DFi-I	Pao	LTR
BEL-2_DFi-LTR	Pao	LTR
BEL-2_DGri-I	Pao	LTR
BEL-2_DGri-LTR	Pao	LTR
BEL-2_DPer-I	Pao	LTR
BEL-2_DPer-LTR	Pao	LTR
BEL-2_DRh-I	Pao	LTR
BEL-2_DRh-LTR	Pao	LTR
BEL-2_DSe-I	Pao	LTR
BEL-2_DSe-LTR	Pao	LTR
BEL-2_DTa-I	Pao	LTR
BEL-2_DTa-LTR	Pao	LTR
BEL-2_DVir-I	Pao	LTR
BEL-2_DVir-LTR	Pao	LTR
BEL-2_DWil-I	Pao	LTR
BEL-2_DWil-LTR	Pao	LTR
BEL-20_DAn-I	Pao	LTR
BEL-20_DAn-LTR	Pao	LTR
BEL-20_DTa-I	Pao	LTR
BEL-20_DTa-LTR	Pao	LTR
BEL-20_DWil-I	Pao	LTR
BEL-20_DWil-LTR	Pao	LTR
BEL-21_DAn-I	Pao	LTR
BEL-21_DAn-LTR	Pao	LTR
BEL-21_DTa-I	Pao	LTR
BEL-21_DTa-LTR	Pao	LTR
BEL-21_DWil-I	Pao	LTR
BEL-21_DWil-LTR	Pao	LTR
BEL-22_DAn-I	Pao	LTR
BEL-22_DAn-LTR	Pao	LTR
BEL-22_DTa-I	Pao	LTR
BEL-22_DTa-LTR	Pao	LTR
BEL-3_DAn-I	Pao	LTR
BEL-3_DAn-LTR	Pao	LTR
BEL-3_DBi-I	Pao	LTR
BEL-3_DBi-LTR	Pao	LTR
BEL-3_DBp-I	Pao	LTR
BEL-3_DBp-LTR	Pao	LTR
BEL-3_DEl-I	Pao	LTR
BEL-3_DEl-LTR	Pao	LTR
BEL-3_Deu-I	Pao	LTR
BEL-3_Deu-LTR	Pao	LTR
BEL-3_DFi-I	Pao	LTR
BEL-3_DFi-LTR	Pao	LTR
BEL-3_DGri-I	Pao	LTR
BEL-3_DGri-LTR	Pao	LTR
BEL-3_DMoj-I	Pao	LTR
BEL-3_DMoj-LTR	Pao	LTR
BEL-3_DPer-I	Pao	LTR
BEL-3_DPer-LTR	Pao	LTR
BEL-3_DRh-I	Pao	LTR
BEL-3_DRh-LTR	Pao	LTR
BEL-3_DTa-I	Pao	LTR
BEL-3_DTa-LTR	Pao	LTR
BEL-3_DVir-I	Pao	LTR
BEL-3_DVir-LTR	Pao	LTR
BEL-3_DWil-I	Pao	LTR
BEL-3_DWil-LTR	Pao	LTR
BEL-3_DYa-I	Pao	LTR
BEL-3_DYa-LTR	Pao	LTR
BEL-4_DAn-I	Pao	LTR
BEL-4_DAn-LTR	Pao	LTR
BEL-4_DBi-I	Pao	LTR
BEL-4_DBi-LTR	Pao	LTR
BEL-4_DBp-I	Pao	LTR
BEL-4_DBp-LTR	Pao	LTR
BEL-4_DEl-I	Pao	LTR
BEL-4_DEl-LTR	Pao	LTR
BEL-4_DEu-I	Pao	LTR
BEL-4_DEu-LTR	Pao	LTR
BEL-4_DFi-I	Pao	LTR
BEL-4_DFi-LTR	Pao	LTR
BEL-4_DMoj-I	Pao	LTR
BEL-4_DMoj-LTR	Pao	LTR
BEL-4_DPer-I	Pao	LTR
BEL-4_DPer-LTR	Pao	LTR
BEL-4_DPse-I	Pao	LTR
BEL-4_DPse-LTR	Pao	LTR
BEL-4_DRh-I	Pao	LTR
BEL-4_DRh-LTR	Pao	LTR
BEL-4_DTa-I	Pao	LTR
BEL-4_DTa-LTR	Pao	LTR
BEL-4_DVir-I	Pao	LTR
BEL-4_DVir-LTR	Pao	LTR
BEL-4_DWil-I	Pao	LTR
BEL-4_DWil-LTR	Pao	LTR
BEL-4_DYa-I	Pao	LTR
BEL-4_DYa-LTR	Pao	LTR
BEL-5_DAn-I	Pao	LTR
BEL-5_DAn-LTR	Pao	LTR
BEL-5_DBp-I	Pao	LTR
BEL-5_DBp-LTR	Pao	LTR
BEL-5_DEl-I	Pao	LTR
BEL-5_DEu-I	Pao	LTR
BEL-5_DEu-LTR	Pao	LTR
BEL-5_DFi-I	Pao	LTR
BEL-5_DFi-LTR	Pao	LTR
BEL-5_DMoj-I	Pao	LTR
BEL-5_DMoj-LTR	Pao	LTR
BEL-5_DPer-I	Pao	LTR
BEL-5_DPer-LTR	Pao	LTR
BEL-5_DRh-I	Pao	LTR
BEL-5_DRh-LTR	Pao	LTR
BEL-5_DTa-I	Pao	LTR
BEL-5_DTa-LTR	Pao	LTR
BEL-5_DVir-I	Pao	LTR
BEL-5_DVir-LTR	Pao	LTR
BEL-5_DWil-I	Pao	LTR
BEL-5_DWil-LTR	Pao	LTR
BEL-5_DYa-I	Pao	LTR
BEL-5_DYa-LTR	Pao	LTR
BEL-6_DAn-I	Pao	LTR
BEL-6_DAn-LTR	Pao	LTR
BEL-6_DBp-I	Pao	LTR
BEL-6_DBp-LTR	Pao	LTR
BEL-6_DEl-I	Pao	LTR
BEL-6_DEl-LTR	Pao	LTR
BEL-6_DMoj-I	Pao	LTR
BEL-6_DMoj-LTR	Pao	LTR
BEL-6_DPe-I	Pao	LTR
BEL-6_DPe-LTR	Pao	LTR
BEL-6_DPer-I	Pao	LTR
BEL-6_DPer-LTR	Pao	LTR
BEL-6_DRh-I	Pao	LTR
BEL-6_DRh-LTR	Pao	LTR
BEL-6_DTa-I	Pao	LTR
BEL-6_DTa-LTR	Pao	LTR
BEL-6_DWil-I	Pao	LTR
BEL-6_DWil-LTR	Pao	LTR
BEL-6_DYa-I	Pao	LTR
BEL-6_DYa-LTR	Pao	LTR
BEL-7_DAn-I	Pao	LTR
BEL-7_DAn-LTR	Pao	LTR
BEL-7_DBp-I	Pao	LTR
BEL-7_DBp-LTR	Pao	LTR
BEL-7_DEl-LTR	Pao	LTR
BEL-7_DMoj-I	Pao	LTR
BEL-7_DMoj-LTR	Pao	LTR
BEL-7_DPe-I	Pao	LTR
BEL-7_DPe-LTR	Pao	LTR
BEL-7_DPer-I	Pao	LTR
BEL-7_DPer-LTR	Pao	LTR
BEL-7_DRh-I	Pao	LTR
BEL-7_DRh-LTR	Pao	LTR
BEL-7_DTa-I	Pao	LTR
BEL-7_DTa-LTR	Pao	LTR
BEL-7_DWil-I	Pao	LTR
BEL-7_DWil-LTR	Pao	LTR
BEL-8_DAn-I	Pao	LTR
BEL-8_DAn-LTR	Pao	LTR
BEL-8_DBp-I	Pao	LTR
BEL-8_DBp-LTR	Pao	LTR
BEL-8_DEl-I	Pao	LTR
BEL-8_DEl-LTR	Pao	LTR
BEL-8_DMo-I	Pao	LTR
BEL-8_DMo-LTR	Pao	LTR
BEL-8_DPe-I	Pao	LTR
BEL-8_DPe-LTR	Pao	LTR
BEL-8_DTa-I	Pao	LTR
BEL-8_DTa-LTR	Pao	LTR
BEL-8_DWil-I	Pao	LTR
BEL-8_DWil-LTR	Pao	LTR
BEL-9_DAn-I	Pao	LTR
BEL-9_DAn-LTR	Pao	LTR
BEL-9_DBp-I	Pao	LTR
BEL-9_DBp-LTR	Pao	LTR
BEL-9_DEl-I	Pao	LTR
BEL-9_DTa-I	Pao	LTR
BEL-9_DTa-LTR	Pao	LTR
BEL-9_DWil-I	Pao	LTR
BEL-9_DWil-LTR	Pao	LTR
BEL1_I_Dpse	Pao	LTR
BEL1_LTR_Dpse	Pao	LTR
BEL1-I_Dmoj	Pao	LTR
BEL1-I_DV	Pao	LTR
BEL1-I_Dya	Pao	LTR
BEL1-LTR_Dmoj	Pao	LTR
BEL1-LTR_DV	Pao	LTR
BEL1-LTR_Dya	Pao	LTR
BEL2-I_Dmoj	Pao	LTR
BEL2-I_Dpse	Pao	LTR
BEL2-I_Dya	Pao	LTR
BEL2-LTR_Dmoj	Pao	LTR
BEL2-LTR_Dpse	Pao	LTR
BEL2-LTR_Dya	Pao	LTR
BEL3_DM-I	Pao	LTR
BEL3_DM-LTR	Pao	LTR
BEL3-I_Dpse	Pao	LTR
BEL3-LTR_Dpse	Pao	LTR
BEL3_DM	Pao	LTR
Bica_I	Gypsy	LTR
Bica_LTR	Gypsy	LTR
Bica	Gypsy	LTR
Bilbo	LOA	Non-LTR_retrotransposon
BLASTOPIA_I	Gypsy	LTR
BLASTOPIA_LTR	Gypsy	LTR
BLASTOPIA	Gypsy	LTR
BLOOD_I	Gypsy	LTR
BLOOD_LTR	Gypsy	LTR
BLOOD	Gypsy	LTR
BS	Jockey	Non-LTR_retrotransposon
BS2	Jockey	Non-LTR_retrotransposon
BS3_DM	Jockey	Non-LTR_retrotransposon
BS4_DM	Jockey	Non-LTR_retrotransposon
BURDOCK_I	Gypsy	LTR
BURDOCK_LTR	Gypsy	LTR
BURDOCK	Gypsy	LTR
Chapaev3-1_DA	CMC-Chapaev-3	DNA
Chapaev3-1_DW	CMC-Chapaev-3	DNA
Chimpo_I	Gypsy	LTR
Chimpo_LTR	Gypsy	LTR
Chimpo	Gypsy	LTR
Chouto_I	Gypsy	LTR
Chouto_LTR	Gypsy	LTR
Chouto	Gypsy	LTR
CIRCE	Gypsy	LTR
Copia_I	Copia	LTR
Copia_LTR	Copia	LTR
Copia-1_DAn-I	Copia	LTR
Copia-1_DAn-LTR	Copia	LTR
Copia-1_DBi-I	Copia	LTR
Copia-1_DBi-LTR	Copia	LTR
Copia-1_DBp-I	Copia	LTR
Copia-1_DBp-LTR	Copia	LTR
Copia-1_DEl-I	Copia	LTR
Copia-1_DEl-LTR	Copia	LTR
Copia-1_Deu-I	Copia	LTR
Copia-1_Deu-LTR	Copia	LTR
Copia-1_DFi-I	Copia	LTR
Copia-1_DFi-LTR	Copia	LTR
Copia-1_DGri-I	Copia	LTR
Copia-1_DGri-LTR	Copia	LTR
Copia-1_DPer-I	Copia	LTR
Copia-1_DPer-LTR	Copia	LTR
Copia-1_DSe-I	Copia	LTR
Copia-1_DSe-LTR	Copia	LTR
Copia-1_DSim-I	Copia	LTR
Copia-1_DSim-LTR	Copia	LTR
Copia-1_DTa-I	Copia	LTR
Copia-1_DTa-LTR	Copia	LTR
Copia-1_DVir-I	Copia	LTR
Copia-1_DVir-LTR	Copia	LTR
Copia-1_DWil-I	Copia	LTR
Copia-1_DWil-LTR	Copia	LTR
Copia-1_DYa-I	Copia	LTR
Copia-1_DYa-LTR	Copia	LTR
Copia-1-I_DY	Copia	LTR
Copia-1-LTR_DY	Copia	LTR
Copia-2_DAn-I	Copia	LTR
Copia-2_DAn-LTR	Copia	LTR
Copia-2_DBp-I	Copia	LTR
Copia-2_DBp-LTR	Copia	LTR
Copia-2_DEl-I	Copia	LTR
Copia-2_DEl-LTR	Copia	LTR
Copia-2_Deu-I	Copia	LTR
Copia-2_Deu-LTR	Copia	LTR
Copia-2_DGri-I	Copia	LTR
Copia-2_DGri-LTR	Copia	LTR
Copia-2_DKi-I	Copia	LTR
Copia-2_DKi-LTR	Copia	LTR
Copia-2_DPer-I	Copia	LTR
Copia-2_DPer-LTR	Copia	LTR
Copia-2_DTa-I	Copia	LTR
Copia-2_DTa-LTR	Copia	LTR
Copia-2_DWil-I	Copia	LTR
Copia-2_DWil-LTR	Copia	LTR
Copia-2_DYa-I	Copia	LTR
Copia-2_DYa-LTR	Copia	LTR
Copia-29_DP-I	Copia	LTR
Copia-29_DP-LTR	Copia	LTR
Copia-3_DAn-I	Copia	LTR
Copia-3_DAn-LTR	Copia	LTR
Copia-3_DBp-I	Copia	LTR
Copia-3_DEu-I	Copia	LTR
Copia-3_DEu-LTR	Copia	LTR
Copia-3_DGri-I	Copia	LTR
Copia-3_DGri-LTR	Copia	LTR
Copia-3_DMoj-I	Copia	LTR
Copia-3_DMoj-LTR	Copia	LTR
Copia-3_DWil-I	Copia	LTR
Copia-3_DWil-LTR	Copia	LTR
Copia-4_DAn-I	Copia	LTR
Copia-4_DAn-LTR	Copia	LTR
Copia-4_DGri-I	Copia	LTR
Copia-4_DGri-LTR	Copia	LTR
Copia-4_DMoj-I	Copia	LTR
Copia-4_DMoj-LTR	Copia	LTR
Copia-4_DWil-I	Copia	LTR
Copia-4_DWil-LTR	Copia	LTR
Copia-5_DAn-I	Copia	LTR
Copia-5_DAn-LTR	Copia	LTR
Copia-5_DWil-I	Copia	LTR
Copia-5_DWil-LTR	Copia	LTR
Copia-6_DAn-I	Copia	LTR
Copia-6_DAn-LTR	Copia	LTR
Copia-6_DWil-I	Copia	LTR
Copia-6_DWil-LTR	Copia	LTR
Copia-7_DAn-I	Copia	LTR
Copia-7_DAn-LTR	Copia	LTR
Copia-7_DWil-I	Copia	LTR
Copia-7_DWil-LTR	Copia	LTR
Copia-8_DAn-I	Copia	LTR
Copia-8_DAn-LTR	Copia	LTR
Copia-8_DWil-I	Copia	LTR
Copia-8_DWil-LTR	Copia	LTR
Copia-9_DWil-I	Copia	LTR
Copia-9_DWil-LTR	Copia	LTR
Copia1-I_DM	Copia	LTR
Copia1-I_Dmoj	Copia	LTR
Copia1-I_Dpse	Copia	LTR
Copia1-LTR_DM	Copia	LTR
Copia1-LTR_Dmoj	Copia	LTR
Copia1-LTR_Dpse	Copia	LTR
Copia2_I	Copia	LTR
Copia2_LTR_DM	Copia	LTR
Copia2-I_Dmoj	Copia	LTR
Copia2-I_Dpse	Copia	LTR
Copia2-LTR_Dmoj	Copia	LTR
Copia2-LTR_Dpse	Copia	LTR
Copia	Copia	LTR
Copia1_DM	Copia	LTR
Copia2	Copia	LTR
CR1-1_DAn	CR1	Non-LTR_retrotransposon
CR1-1_DBi	CR1	Non-LTR_retrotransposon
CR1-1_DBp	CR1	Non-LTR_retrotransposon
CR1-1_DEl	CR1	Non-LTR_retrotransposon
CR1-1_DEu	CR1	Non-LTR_retrotransposon
CR1-1_DF	CR1	Non-LTR_retrotransposon
CR1-1_DK	CR1	Non-LTR_retrotransposon
CR1-1_DPer	CR1	Non-LTR_retrotransposon
CR1-1_DRh	CR1	Non-LTR_retrotransposon
CR1-1_DT	CR1	Non-LTR_retrotransposon
CR1-1_DVi	CR1	Non-LTR_retrotransposon
CR1-1_DWil	CR1	Non-LTR_retrotransposon
CR1-10_DTa	CR1	Non-LTR_retrotransposon
CR1-2_DAn	CR1	Non-LTR_retrotransposon
CR1-2_DBi	CR1	Non-LTR_retrotransposon
CR1-2_DBp	CR1	Non-LTR_retrotransposon
CR1-2_DEl	CR1	Non-LTR_retrotransposon
CR1-2_DEu	CR1	Non-LTR_retrotransposon
CR1-2_DF	CR1	Non-LTR_retrotransposon
CR1-2_DK	CR1	Non-LTR_retrotransposon
CR1-2_DPer	CR1	Non-LTR_retrotransposon
CR1-2_DRh	CR1	Non-LTR_retrotransposon
CR1-2_DT	CR1	Non-LTR_retrotransposon
CR1-2_DWi	CR1	Non-LTR_retrotransposon
CR1-3_DAn	CR1	Non-LTR_retrotransposon
CR1-3_DBi	CR1	Non-LTR_retrotransposon
CR1-3_DBp	CR1	Non-LTR_retrotransposon
CR1-3_DEl	CR1	Non-LTR_retrotransposon
CR1-3_DK	CR1	Non-LTR_retrotransposon
CR1-3_DPer	CR1	Non-LTR_retrotransposon
CR1-3_DT	CR1	Non-LTR_retrotransposon
CR1-3_DWi	CR1	Non-LTR_retrotransposon
CR1-4_DAn	CR1	Non-LTR_retrotransposon
CR1-4_DBi	CR1	Non-LTR_retrotransposon
CR1-4_DEl	CR1	Non-LTR_retrotransposon
CR1-4_DK	CR1	Non-LTR_retrotransposon
CR1-4_DRh	CR1	Non-LTR_retrotransposon
CR1-4_DT	CR1	Non-LTR_retrotransposon
CR1-4_DWi	CR1	Non-LTR_retrotransposon
CR1-5_DEl	CR1	Non-LTR_retrotransposon
CR1-5_DK	CR1	Non-LTR_retrotransposon
CR1-5_DRh	CR1	Non-LTR_retrotransposon
CR1-5_DT	CR1	Non-LTR_retrotransposon
CR1-6_DT	CR1	Non-LTR_retrotransposon
CR1-7_DT	CR1	Non-LTR_retrotransposon
CR1-8_DTa	CR1	Non-LTR_retrotransposon
CR1-9_DTa	CR1	Non-LTR_retrotransposon
Daraw1cons	TcMar-Mariner	DNA
Dbusck2cons	TcMar-Mariner	DNA
Dbuski1cons	TcMar-Mariner	DNA
Dcardi9	TcMar-Mariner	DNA
DGRSAT1	Satellite	Satellite
DGYSAT1	Satellite	Satellite
DIVER_I	Pao	LTR
DIVER_LTR	Pao	LTR
DIVER2_I	Pao	LTR
DIVER2_LTR	Pao	LTR
DIVER	Pao	LTR
DIVER2	Pao	LTR
DM1731_I	Copia	LTR
DM1731_LTR	Copia	LTR
DM1731	Copia	LTR
DM176_I	Gypsy	LTR
DM176_LTR	Gypsy	LTR
DM176	Gypsy	LTR
DM297_I	Gypsy	LTR
DM297_LTR	Gypsy	LTR
DM297	Gypsy	LTR
DM412	Gypsy	LTR
DM412B_LTR	Gypsy	LTR
Dmacul5	TcMar-Mariner	DNA
dmau_rDNA_18S_rDNA	rDNA	Other
dmau_rDNA_28S_rDNA	rDNA	Other
dmau_rDNA_5_8S_rDNA	rDNA	Other
dmau_rDNA_ETS	rDNA	Other
dmau_rDNA_ITS1	rDNA	Other
dmau_rDNA_ITS2	rDNA	Other
DMCR1A	CR1	Non-LTR_retrotransposon
Dmedpu1cons	TcMar-Mariner	DNA
Dmedpu27	TcMar-Mariner	DNA
Dmedtr1cons	TcMar-Mariner	DNA
dmel_rDNA_18S_rDNA	rDNA	Other
dmel_rDNA_28S_rDNA	rDNA	Other
dmel_rDNA_2s_rDNA	rDNA	Other
dmel_rDNA_5_8S_rDNA	rDNA	Other
dmel_rDNA_ETS	rDNA	Other
dmel_rDNA_ITS1	rDNA	Other
dmel_rDNA_ITS2	rDNA	Other
DMLTR5	Gypsy	LTR
DMR_DV	Other	Other
DMRP1	Other	Other
DMRPR	Other	Other
DMRT1A	R1	Non-LTR_retrotransposon
DMRT1B	R1	Non-LTR_retrotransposon
DMRT1C	R1	Non-LTR_retrotransposon
DMTOM1_LTR	Gypsy	LTR
DNA-1_DBp	DNA	DNA
DNA-1_DEu	DNA	DNA
DNA-1_DPe	DNA	DNA
DNA-2_DBp	DNA	DNA
DNA-TA-1_DF	TcMar	DNA
DNA-TA-1_DTa	DNA	DNA
DNA2-1_DAn	DNA	DNA
DNA3-1_DF	DNA	DNA
DNA3-1_DTa	DNA	DNA
DNA3-2_DTa	DNA	DNA
DNA4-1_DK	Helitron	RC
DNA7-1_DEl	P	DNA
DNA8-1_DEl	DNA	DNA
DNAREP1_DM	Helitron	RC
DNAREP1_DSim	Helitron	RC
DNAREP1_DYak	Helitron	RC
DNAREP2_DSim	Helitron	RC
Dneoca1	TcMar-Mariner	DNA
Dneoca19	TcMar-Mariner	DNA
Dneoca1cons	TcMar-Mariner	DNA
DOC	Jockey	Non-LTR_retrotransposon
DOC2_DM	Jockey	Non-LTR_retrotransposon
DOC3_DM	Jockey	Non-LTR_retrotransposon
DOC4_DM	Jockey	Non-LTR_retrotransposon
DOC5_DM	Jockey	Non-LTR_retrotransposon
DOC6_DM	Jockey	Non-LTR_retrotransposon
DODECA_SAT	Satellite	Satellite
Dorna1cons	TcMar-Mariner	DNA
Dpalli7	TcMar-Mariner	DNA
Dparag19	TcMar-Mariner	DNA
Dparag30	TcMar-Mariner	DNA
Dparam1cons	TcMar-Mariner	DNA
Dparam2cons	TcMar-Mariner	DNA
Dpauli6	TcMar-Mariner	DNA
DSAT	Satellite	Satellite
dsech_rDNA_18S_rDNA	rDNA	Other
dsech_rDNA_28S_rDNA	rDNA	Other
dsech_rDNA_5_8S_rDNA	rDNA	Other
dsech_rDNA_ETS	rDNA	Other
dsech_rDNA_ITS1	rDNA	Other
dsech_rDNA_ITS2	rDNA	Other
dsim_rDNA_18S_rDNA	rDNA	Other
dsim_rDNA_28S_rDNA	rDNA	Other
dsim_rDNA_5_8S_rDNA	rDNA	Other
dsim_rDNA_ETS	rDNA	Other
dsim_rDNA_ITS1	rDNA	Other
dsim_rDNA_ITS2	rDNA	Other
Dtripu1cons	TcMar-Mariner	DNA
Dtripu2cons	TcMar-Mariner	DNA
DTSAT1	Satellite	Satellite
EnSpm-1_DF	CMC-Chapaev-3	DNA
FB4_DM	TcMar-Tc1	DNA
FROGGER_I	Copia	LTR
FROGGER_LTR	Copia	LTR
FROGGER	Copia	LTR
FW_DM	Jockey	Non-LTR_retrotransposon
FW2_DM	Jockey	Non-LTR_retrotransposon
FW3_DM	Jockey	Non-LTR_retrotransposon
G_DM	Jockey	Non-LTR_retrotransposon
G2_DM	Jockey	Non-LTR_retrotransposon
G3_DM	Jockey	Non-LTR_retrotransposon
G4_DM	Jockey	Non-LTR_retrotransposon
G5_DM	Jockey	Non-LTR_retrotransposon
G5A_DM	Jockey	Non-LTR_retrotransposon
G6_DM	Jockey	Non-LTR_retrotransposon
G7_DM	Jockey	Non-LTR_retrotransposon
Galileo_DB	P	DNA
Galileo_DM	P	DNA
Galileo_DW	P	DNA
GC_rich	Low_complexity	Low_complexity
GTWIN_I	Gypsy	LTR
GTWIN_LTR	Gypsy	LTR
GTWIN	Gypsy	LTR
Gypsy_6B	Gypsy	LTR
Gypsy_DG_I	Gypsy	LTR
Gypsy_DG_LTR	Gypsy	LTR
Gypsy_DS	Gypsy	LTR
Gypsy_I	Gypsy	LTR
Gypsy_LTR	Gypsy	LTR
Gypsy-1_DAn-I	Gypsy	LTR
Gypsy-1_DAn-LTR	Gypsy	LTR
Gypsy-1_DBi-I	Gypsy	LTR
Gypsy-1_DBi-LTR	Gypsy	LTR
Gypsy-1_DBp-I	Gypsy	LTR
Gypsy-1_DBp-LTR	Gypsy	LTR
Gypsy-1_DEl-I	Gypsy	LTR
Gypsy-1_DEl-LTR	Gypsy	LTR
Gypsy-1_Deu-I	Gypsy	LTR
Gypsy-1_Deu-LTR	Gypsy	LTR
Gypsy-1_DFi-I	Gypsy	LTR
Gypsy-1_DFi-LTR	Gypsy	LTR
Gypsy-1_DG-I	Gypsy	LTR
Gypsy-1_DG-LTR	Gypsy	LTR
Gypsy-1_DGri-I	Gypsy	LTR
Gypsy-1_DGri-LTR	Gypsy	LTR
Gypsy-1_DKi-I	Gypsy	LTR
Gypsy-1_DKi-LTR	Gypsy	LTR
Gypsy-1_DPer-I	Gypsy	LTR
Gypsy-1_DPer-LTR	Gypsy	LTR
Gypsy-1_DRh-I	Gypsy	LTR
Gypsy-1_DRh-LTR	Gypsy	LTR
Gypsy-1_DSe-I	Gypsy	LTR
Gypsy-1_DSe-LTR	Gypsy	LTR
Gypsy-1_DSim-I	Gypsy	LTR
Gypsy-1_DSim-LTR	Gypsy	LTR
Gypsy-1_DTa-I	Gypsy	LTR
Gypsy-1_DTa-LTR	Gypsy	LTR
Gypsy-1_DVir-I	Gypsy	LTR
Gypsy-1_DVir-LTR	Gypsy	LTR
Gypsy-1_DWil-I	Gypsy	LTR
Gypsy-1_DWil-LTR	Gypsy	LTR
Gypsy-10_DAn-I	Gypsy	LTR
Gypsy-10_DAn-LTR	Gypsy	LTR
Gypsy-10_DBp-I	Gypsy	LTR
Gypsy-10_DEl-I	Gypsy	LTR
Gypsy-10_DEl-LTR	Gypsy	LTR
Gypsy-10_DEu-I	Gypsy	LTR
Gypsy-10_DEu-LTR	Gypsy	LTR
Gypsy-10_DFi-I	Gypsy	LTR
Gypsy-10_DFi-LTR	Gypsy	LTR
Gypsy-10_DMoj-I	Gypsy	LTR
Gypsy-10_DMoj-LTR	Gypsy	LTR
Gypsy-10_DPer-I	Gypsy	LTR
Gypsy-10_DPer-LTR	Gypsy	LTR
Gypsy-10_DRh-I	Gypsy	LTR
Gypsy-10_DRh-LTR	Gypsy	LTR
Gypsy-10_DSim-I	Gypsy	LTR
Gypsy-10_DTa-I	Gypsy	LTR
Gypsy-10_DTa-LTR	Gypsy	LTR
Gypsy-10_DVir-I	Gypsy	LTR
Gypsy-10_DVir-LTR	Gypsy	LTR
Gypsy-10_DWil-I	Gypsy	LTR
Gypsy-10_DWil-LTR	Gypsy	LTR
Gypsy-11_DAn-I	Gypsy	LTR
Gypsy-11_DAn-LTR	Gypsy	LTR
Gypsy-11_DBi-I	Gypsy	LTR
Gypsy-11_DBp-I	Gypsy	LTR
Gypsy-11_DEl-I	Gypsy	LTR
Gypsy-11_DEl-LTR	Gypsy	LTR
Gypsy-11_DEu-I	Gypsy	LTR
Gypsy-11_DEu-LTR	Gypsy	LTR
Gypsy-11_DFi-I	Gypsy	LTR
Gypsy-11_DFi-LTR	Gypsy	LTR
Gypsy-11_DPer-I	Gypsy	LTR
Gypsy-11_DPer-LTR	Gypsy	LTR
Gypsy-11_DRh-I	Gypsy	LTR
Gypsy-11_DRh-LTR	Gypsy	LTR
Gypsy-11_DSim-I	Gypsy	LTR
Gypsy-11_DSim-LTR	Gypsy	LTR
Gypsy-11_DTa-I	Gypsy	LTR
Gypsy-11_DTa-LTR	Gypsy	LTR
Gypsy-11_DVir-I	Gypsy	LTR
Gypsy-11_DVir-LTR	Gypsy	LTR
Gypsy-11_DWil-I	Gypsy	LTR
Gypsy-11_DWil-LTR	Gypsy	LTR
Gypsy-12_DAn-I	Gypsy	LTR
Gypsy-12_DAn-LTR	Gypsy	LTR
Gypsy-12_DBp-I	Gypsy	LTR
Gypsy-12_DBp-LTR	Gypsy	LTR
Gypsy-12_DEl-I	Gypsy	LTR
Gypsy-12_DEl-LTR	Gypsy	LTR
Gypsy-12_DEu-I	Gypsy	LTR
Gypsy-12_DEu-LTR	Gypsy	LTR
Gypsy-12_DFi-I	Gypsy	LTR
Gypsy-12_DFi-LTR	Gypsy	LTR
Gypsy-12_DPer-I	Gypsy	LTR
Gypsy-12_DPer-LTR	Gypsy	LTR
Gypsy-12_DRh-I	Gypsy	LTR
Gypsy-12_DRh-LTR	Gypsy	LTR
Gypsy-12_DSim-I	Gypsy	LTR
Gypsy-12_DSim-LTR	Gypsy	LTR
Gypsy-12_DTa-I	Gypsy	LTR
Gypsy-12_DTa-LTR	Gypsy	LTR
Gypsy-12_DVir-I	Gypsy	LTR
Gypsy-12_DVir-LTR	Gypsy	LTR
Gypsy-12_DWil-I	Gypsy	LTR
Gypsy-12_DWil-LTR	Gypsy	LTR
Gypsy-13_DAn-I	Gypsy	LTR
Gypsy-13_DAn-LTR	Gypsy	LTR
Gypsy-13_DBi-I	Gypsy	LTR
Gypsy-13_DBi-LTR	Gypsy	LTR
Gypsy-13_DBp-I	Gypsy	LTR
Gypsy-13_DBp-LTR	Gypsy	LTR
Gypsy-13_DEl-I	Gypsy	LTR
Gypsy-13_DEl-LTR	Gypsy	LTR
Gypsy-13_DEu-I	Gypsy	LTR
Gypsy-13_DEu-LTR	Gypsy	LTR
Gypsy-13_DFi-I	Gypsy	LTR
Gypsy-13_DFi-LTR	Gypsy	LTR
Gypsy-13_DRh-I	Gypsy	LTR
Gypsy-13_DRh-LTR	Gypsy	LTR
Gypsy-13_DSim-I	Gypsy	LTR
Gypsy-13_DSim-LTR	Gypsy	LTR
Gypsy-13_DTa-I	Gypsy	LTR
Gypsy-13_DTa-LTR	Gypsy	LTR
Gypsy-13_DVir-I	Gypsy	LTR
Gypsy-13_DVir-LTR	Gypsy	LTR
Gypsy-13_DWil-I	Gypsy	LTR
Gypsy-13_DWil-LTR	Gypsy	LTR
Gypsy-14_DAn-I	Gypsy	LTR
Gypsy-14_DAn-LTR	Gypsy	LTR
Gypsy-14_DBi-I	Gypsy	LTR
Gypsy-14_DBi-LTR	Gypsy	LTR
Gypsy-14_DBp-I	Gypsy	LTR
Gypsy-14_DBp-LTR	Gypsy	LTR
Gypsy-14_DEl-I	Gypsy	LTR
Gypsy-14_DEl-LTR	Gypsy	LTR
Gypsy-14_DEu-I	Gypsy	LTR
Gypsy-14_DEu-LTR	Gypsy	LTR
Gypsy-14_DFi-I	Gypsy	LTR
Gypsy-14_DFi-LTR	Gypsy	LTR
Gypsy-14_DRh-I	Gypsy	LTR
Gypsy-14_DRh-LTR	Gypsy	LTR
Gypsy-14_DTa-I	Gypsy	LTR
Gypsy-14_DTa-LTR	Gypsy	LTR
Gypsy-14_DWil-I	Gypsy	LTR
Gypsy-14_DWil-LTR	Gypsy	LTR
Gypsy-14B_DWil-I	Gypsy	LTR
Gypsy-14B_DWil-LTR	Gypsy	LTR
Gypsy-15_DAn-I	Gypsy	LTR
Gypsy-15_DAn-LTR	Gypsy	LTR
Gypsy-15_DBi-I	Gypsy	LTR
Gypsy-15_DBi-LTR	Gypsy	LTR
Gypsy-15_DBp-I	Gypsy	LTR
Gypsy-15_DBp-LTR	Gypsy	LTR
Gypsy-15_DEl-I	Gypsy	LTR
Gypsy-15_DEl-LTR	Gypsy	LTR
Gypsy-15_DFi-LTR	Gypsy	LTR
Gypsy-15_DRh-I	Gypsy	LTR
Gypsy-15_DRh-LTR	Gypsy	LTR
Gypsy-15_DTa-I	Gypsy	LTR
Gypsy-15_DTa-LTR	Gypsy	LTR
Gypsy-15_DWil-I	Gypsy	LTR
Gypsy-15_DWil-LTR	Gypsy	LTR
Gypsy-16_DAn-I	Gypsy	LTR
Gypsy-16_DAn-LTR	Gypsy	LTR
Gypsy-16_DBi-I	Gypsy	LTR
Gypsy-16_DBi-LTR	Gypsy	LTR
Gypsy-16_DBp-I	Gypsy	LTR
Gypsy-16_DEl-I	Gypsy	LTR
Gypsy-16_DEl-LTR	Gypsy	LTR
Gypsy-16_DRh-I	Gypsy	LTR
Gypsy-16_DRh-LTR	Gypsy	LTR
Gypsy-16_DTa-I	Gypsy	LTR
Gypsy-16_DTa-LTR	Gypsy	LTR
Gypsy-16_DWil-I	Gypsy	LTR
Gypsy-16_DWil-LTR	Gypsy	LTR
Gypsy-17_DAn-I	Gypsy	LTR
Gypsy-17_DAn-LTR	Gypsy	LTR
Gypsy-17_DBi-I	Gypsy	LTR
Gypsy-17_DBi-LTR	Gypsy	LTR
Gypsy-17_DBp-I	Gypsy	LTR
Gypsy-17_DBp-LTR	Gypsy	LTR
Gypsy-17_DEl-I	Gypsy	LTR
Gypsy-17_DEl-LTR	Gypsy	LTR
Gypsy-17_DRh-I	Gypsy	LTR
Gypsy-17_DRh-LTR	Gypsy	LTR
Gypsy-17_DTa-I	Gypsy	LTR
Gypsy-17_DTa-LTR	Gypsy	LTR
Gypsy-17_DWil-I	Gypsy	LTR
Gypsy-17_DWil-LTR	Gypsy	LTR
Gypsy-18_DAn-I	Gypsy	LTR
Gypsy-18_DAn-LTR	Gypsy	LTR
Gypsy-18_DBp-I	Gypsy	LTR
Gypsy-18_DEl-I	Gypsy	LTR
Gypsy-18_DEl-LTR	Gypsy	LTR
Gypsy-18_DTa-I	Gypsy	LTR
Gypsy-18_DTa-LTR	Gypsy	LTR
Gypsy-18_DWil-I	Gypsy	LTR
Gypsy-18_DWil-LTR	Gypsy	LTR
Gypsy-19_DAn-I	Gypsy	LTR
Gypsy-19_DAn-LTR	Gypsy	LTR
Gypsy-19_DBp-I	Gypsy	LTR
Gypsy-19_DBp-LTR	Gypsy	LTR
Gypsy-19_DEl-I	Gypsy	LTR
Gypsy-19_DEl-LTR	Gypsy	LTR
Gypsy-19_DTa-I	Gypsy	LTR
Gypsy-19_DWil-I	Gypsy	LTR
Gypsy-19_DWil-LTR	Gypsy	LTR
Gypsy-1A_DPer-LTR	Gypsy	LTR
Gypsy-2_DAn-I	Gypsy	LTR
Gypsy-2_DAn-LTR	Gypsy	LTR
Gypsy-2_DBi-I	Gypsy	LTR
Gypsy-2_DBi-LTR	Gypsy	LTR
Gypsy-2_DBp-I	Gypsy	LTR
Gypsy-2_DBp-LTR	Gypsy	LTR
Gypsy-2_DEl-I	Gypsy	LTR
Gypsy-2_DEl-LTR	Gypsy	LTR
Gypsy-2_Deu-I	Gypsy	LTR
Gypsy-2_Deu-LTR	Gypsy	LTR
Gypsy-2_DFi-I	Gypsy	LTR
Gypsy-2_DFi-LTR	Gypsy	LTR
Gypsy-2_DGri-I	Gypsy	LTR
Gypsy-2_DGri-LTR	Gypsy	LTR
Gypsy-2_DKi-I	Gypsy	LTR
Gypsy-2_DKi-LTR	Gypsy	LTR
Gypsy-2_DPer-I	Gypsy	LTR
Gypsy-2_DPer-LTR	Gypsy	LTR
Gypsy-2_DRh-I	Gypsy	LTR
Gypsy-2_DRh-LTR	Gypsy	LTR
Gypsy-2_DSe-I	Gypsy	LTR
Gypsy-2_DSe-LTR	Gypsy	LTR
Gypsy-2_DSim-I	Gypsy	LTR
Gypsy-2_DSim-LTR	Gypsy	LTR
Gypsy-2_DTa-I	Gypsy	LTR
Gypsy-2_DTa-LTR	Gypsy	LTR
Gypsy-2_DVir-I	Gypsy	LTR
Gypsy-2_DVir-LTR	Gypsy	LTR
Gypsy-2_DWil-I	Gypsy	LTR
Gypsy-2_DWil-LTR	Gypsy	LTR
Gypsy-20_DAn-I	Gypsy	LTR
Gypsy-20_DAn-LTR	Gypsy	LTR
Gypsy-20_DBp-I	Gypsy	LTR
Gypsy-20_DBp-LTR	Gypsy	LTR
Gypsy-20_DEl-I	Gypsy	LTR
Gypsy-20_DTa-I	Gypsy	LTR
Gypsy-20_DTa-LTR	Gypsy	LTR
Gypsy-20_DWil-I	Gypsy	LTR
Gypsy-20_DWil-LTR	Gypsy	LTR
Gypsy-21_DAn-I	Gypsy	LTR
Gypsy-21_DAn-LTR	Gypsy	LTR
Gypsy-21_DBp-I	Gypsy	LTR
Gypsy-21_DEl-I	Gypsy	LTR
Gypsy-21_DEl-LTR	Gypsy	LTR
Gypsy-21_DWil-I	Gypsy	LTR
Gypsy-21_DWil-LTR	Gypsy	LTR
Gypsy-21_DY-I	Gypsy	LTR
Gypsy-21_DY-LTR	Gypsy	LTR
Gypsy-21_DYa-I	Gypsy	LTR
Gypsy-21_DYa-LTR	Gypsy	LTR
Gypsy-22_DAn-I	Gypsy	LTR
Gypsy-22_DAn-LTR	Gypsy	LTR
Gypsy-22_DBp-I	Gypsy	LTR
Gypsy-22_DBp-LTR	Gypsy	LTR
Gypsy-22_DEl-I	Gypsy	LTR
Gypsy-22_DEl-LTR	Gypsy	LTR
Gypsy-22_DWil-I	Gypsy	LTR
Gypsy-22_DWil-LTR	Gypsy	LTR
Gypsy-22_DY-I	Gypsy	LTR
Gypsy-22_DY-LTR	Gypsy	LTR
Gypsy-22_DYa-I	Gypsy	LTR
Gypsy-22_DYa-LTR	Gypsy	LTR
Gypsy-23_DAn-I	Gypsy	LTR
Gypsy-23_DAn-LTR	Gypsy	LTR
Gypsy-23_DBp-I	Gypsy	LTR
Gypsy-23_DEl-I	Gypsy	LTR
Gypsy-23_DEl-LTR	Gypsy	LTR
Gypsy-23_DWil-I	Gypsy	LTR
Gypsy-23_DWil-LTR	Gypsy	LTR
Gypsy-23_DY-I	Gypsy	LTR
Gypsy-23_DY-LTR	Gypsy	LTR
Gypsy-23_DYa-I	Gypsy	LTR
Gypsy-23_DYa-LTR	Gypsy	LTR
Gypsy-24_DAn-I	Gypsy	LTR
Gypsy-24_DAn-LTR	Gypsy	LTR
Gypsy-24_DBp-I	Gypsy	LTR
Gypsy-24_DEl-I	Gypsy	LTR
Gypsy-24_DEl-LTR	Gypsy	LTR
Gypsy-24_DWil-I	Gypsy	LTR
Gypsy-24_DWil-LTR	Gypsy	LTR
Gypsy-24_DY-I	Gypsy	LTR
Gypsy-24_DY-LTR	Gypsy	LTR
Gypsy-24_DYa-I	Gypsy	LTR
Gypsy-24_DYa-LTR	Gypsy	LTR
Gypsy-25_DAn-I	Gypsy	LTR
Gypsy-25_DAn-LTR	Gypsy	LTR
Gypsy-25_DBp-I	Gypsy	LTR
Gypsy-25_DEl-I	Gypsy	LTR
Gypsy-25_DP-I	Gypsy	LTR
Gypsy-25_DP-LTR	Gypsy	LTR
Gypsy-25_DPse-I	Gypsy	LTR
Gypsy-25_DPse-LTR	Gypsy	LTR
Gypsy-25_DWil-I	Gypsy	LTR
Gypsy-25_DWil-LTR	Gypsy	LTR
Gypsy-25_DYa-I	Gypsy	LTR
Gypsy-25_DYa-LTR	Gypsy	LTR
Gypsy-26_DAn-I	Gypsy	LTR
Gypsy-26_DAn-LTR	Gypsy	LTR
Gypsy-26_DBp-I	Gypsy	LTR
Gypsy-26_DEl-I	Gypsy	LTR
Gypsy-26_DP-I	Gypsy	LTR
Gypsy-26_DP-LTR	Gypsy	LTR
Gypsy-26_DPse-I	Gypsy	LTR
Gypsy-26_DPse-LTR	Gypsy	LTR
Gypsy-26_DWil-I	Gypsy	LTR
Gypsy-26_DWil-LTR	Gypsy	LTR
Gypsy-26_DYa-I	Gypsy	LTR
Gypsy-26_DYa-LTR	Gypsy	LTR
Gypsy-27_DAn-I	Gypsy	LTR
Gypsy-27_DAn-LTR	Gypsy	LTR
Gypsy-27_DBp-I	Gypsy	LTR
Gypsy-27_DEl-I	Gypsy	LTR
Gypsy-27_DEl-LTR	Gypsy	LTR
Gypsy-27_DP-I	Gypsy	LTR
Gypsy-27_DP-LTR	Gypsy	LTR
Gypsy-27_DWil-I	Gypsy	LTR
Gypsy-27_DWil-LTR	Gypsy	LTR
Gypsy-27_DYa-I	Gypsy	LTR
Gypsy-27_DYa-LTR	Gypsy	LTR
Gypsy-28_DAn-I	Gypsy	LTR
Gypsy-28_DAn-LTR	Gypsy	LTR
Gypsy-28_DBp-I	Gypsy	LTR
Gypsy-28_DEl-I	Gypsy	LTR
Gypsy-28_DEl-LTR	Gypsy	LTR
Gypsy-28_DWil-I	Gypsy	LTR
Gypsy-28_DWil-LTR	Gypsy	LTR
Gypsy-28_DYa-I	Gypsy	LTR
Gypsy-28_DYa-LTR	Gypsy	LTR
Gypsy-29_DAn-I	Gypsy	LTR
Gypsy-29_DAn-LTR	Gypsy	LTR
Gypsy-29_DEl-I	Gypsy	LTR
Gypsy-29_DWil-I	Gypsy	LTR
Gypsy-29_DWil-LTR	Gypsy	LTR
Gypsy-29_DYa-I	Gypsy	LTR
Gypsy-29_DYa-LTR	Gypsy	LTR
Gypsy-3_DAn-I	Gypsy	LTR
Gypsy-3_DAn-LTR	Gypsy	LTR
Gypsy-3_DBi-I	Gypsy	LTR
Gypsy-3_DBi-LTR	Gypsy	LTR
Gypsy-3_DBp-I	Gypsy	LTR
Gypsy-3_DBp-LTR	Gypsy	LTR
Gypsy-3_DEl-I	Gypsy	LTR
Gypsy-3_DEl-LTR	Gypsy	LTR
Gypsy-3_Deu-I	Gypsy	LTR
Gypsy-3_Deu-LTR	Gypsy	LTR
Gypsy-3_DFi-I	Gypsy	LTR
Gypsy-3_DFi-LTR	Gypsy	LTR
Gypsy-3_DGri-I	Gypsy	LTR
Gypsy-3_DGri-LTR	Gypsy	LTR
Gypsy-3_DKi-I	Gypsy	LTR
Gypsy-3_DKi-LTR	Gypsy	LTR
Gypsy-3_DPer-I	Gypsy	LTR
Gypsy-3_DPer-LTR	Gypsy	LTR
Gypsy-3_DRh-I	Gypsy	LTR
Gypsy-3_DRh-LTR	Gypsy	LTR
Gypsy-3_DSe-I	Gypsy	LTR
Gypsy-3_DSe-LTR	Gypsy	LTR
Gypsy-3_DSim-I	Gypsy	LTR
Gypsy-3_DSim-LTR	Gypsy	LTR
Gypsy-3_DTa-I	Gypsy	LTR
Gypsy-3_DTa-LTR	Gypsy	LTR
Gypsy-3_DVir-I	Gypsy	LTR
Gypsy-3_DVir-LTR	Gypsy	LTR
Gypsy-3_DWil-I	Gypsy	LTR
Gypsy-3_DWil-LTR	Gypsy	LTR
Gypsy-30_DAn-I	Gypsy	LTR
Gypsy-30_DAn-LTR	Gypsy	LTR
Gypsy-30_DEl-I	Gypsy	LTR
Gypsy-30_DEl-LTR	Gypsy	LTR
Gypsy-30_DWil-I	Gypsy	LTR
Gypsy-30_DWil-LTR	Gypsy	LTR
Gypsy-30_DYa-I	Gypsy	LTR
Gypsy-30_DYa-LTR	Gypsy	LTR
Gypsy-31_DAn-I	Gypsy	LTR
Gypsy-31_DAn-LTR	Gypsy	LTR
Gypsy-31_DEl-I	Gypsy	LTR
Gypsy-31_DEl-LTR	Gypsy	LTR
Gypsy-31_DP-I	Gypsy	LTR
Gypsy-31_DP-LTR	Gypsy	LTR
Gypsy-31_DWil-I	Gypsy	LTR
Gypsy-31_DWil-LTR	Gypsy	LTR
Gypsy-31_DYa-I	Gypsy	LTR
Gypsy-31_DYa-LTR	Gypsy	LTR
Gypsy-32_DAn-I	Gypsy	LTR
Gypsy-32_DAn-LTR	Gypsy	LTR
Gypsy-32_DEl-I	Gypsy	LTR
Gypsy-32_DP-I	Gypsy	LTR
Gypsy-32_DP-LTR	Gypsy	LTR
Gypsy-32_DWil-I	Gypsy	LTR
Gypsy-32_DWil-LTR	Gypsy	LTR
Gypsy-32_DYa-I	Gypsy	LTR
Gypsy-32_DYa-LTR	Gypsy	LTR
Gypsy-33_DAn-I	Gypsy	LTR
Gypsy-33_DAn-LTR	Gypsy	LTR
Gypsy-33_DEl-I	Gypsy	LTR
Gypsy-33_DWil-I	Gypsy	LTR
Gypsy-33_DWil-LTR	Gypsy	LTR
Gypsy-34_DAn-I	Gypsy	LTR
Gypsy-34_DAn-LTR	Gypsy	LTR
Gypsy-34_DEl-I	Gypsy	LTR
Gypsy-34_DWil-I	Gypsy	LTR
Gypsy-34_DWil-LTR	Gypsy	LTR
Gypsy-35_DAn-I	Gypsy	LTR
Gypsy-35_DAn-LTR	Gypsy	LTR
Gypsy-35_DEl-I	Gypsy	LTR
Gypsy-35_DWil-I	Gypsy	LTR
Gypsy-35_DWil-LTR	Gypsy	LTR
Gypsy-36_DAn-I	Gypsy	LTR
Gypsy-36_DAn-LTR	Gypsy	LTR
Gypsy-36_DEl-I	Gypsy	LTR
Gypsy-36_DWil-I	Gypsy	LTR
Gypsy-36_DWil-LTR	Gypsy	LTR
Gypsy-37_DAn-I	Gypsy	LTR
Gypsy-37_DAn-LTR	Gypsy	LTR
Gypsy-37_DEl-I	Gypsy	LTR
Gypsy-37_DWil-I	Gypsy	LTR
Gypsy-37_DWil-LTR	Gypsy	LTR
Gypsy-37B_DWil-LTR	Gypsy	LTR
Gypsy-38_DAn-I	Gypsy	LTR
Gypsy-38_DAn-LTR	Gypsy	LTR
Gypsy-38_DEl-I	Gypsy	LTR
Gypsy-38_DWil-I	Gypsy	LTR
Gypsy-38_DWil-LTR	Gypsy	LTR
Gypsy-39_DAn-I	Gypsy	LTR
Gypsy-39_DAn-LTR	Gypsy	LTR
Gypsy-39_DWil-LTR	Gypsy	LTR
Gypsy-4_DAn-I	Gypsy	LTR
Gypsy-4_DAn-LTR	Gypsy	LTR
Gypsy-4_DBi-I	Gypsy	LTR
Gypsy-4_DBi-LTR	Gypsy	LTR
Gypsy-4_DBp-I	Gypsy	LTR
Gypsy-4_DBp-LTR	Gypsy	LTR
Gypsy-4_DEl-I	Gypsy	LTR
Gypsy-4_DEl-LTR	Gypsy	LTR
Gypsy-4_Deu-I	Gypsy	LTR
Gypsy-4_Deu-LTR	Gypsy	LTR
Gypsy-4_DFi-I	Gypsy	LTR
Gypsy-4_DFi-LTR	Gypsy	LTR
Gypsy-4_DGri-I	Gypsy	LTR
Gypsy-4_DGri-LTR	Gypsy	LTR
Gypsy-4_DKi-I	Gypsy	LTR
Gypsy-4_DKi-LTR	Gypsy	LTR
Gypsy-4_DPer-I	Gypsy	LTR
Gypsy-4_DPer-LTR	Gypsy	LTR
Gypsy-4_DRh-I	Gypsy	LTR
Gypsy-4_DRh-LTR	Gypsy	LTR
Gypsy-4_DSe-I	Gypsy	LTR
Gypsy-4_DSe-LTR	Gypsy	LTR
Gypsy-4_DSim-I	Gypsy	LTR
Gypsy-4_DSim-LTR	Gypsy	LTR
Gypsy-4_DTa-I	Gypsy	LTR
Gypsy-4_DTa-LTR	Gypsy	LTR
Gypsy-4_DVir-I	Gypsy	LTR
Gypsy-4_DVir-LTR	Gypsy	LTR
Gypsy-4_DWil-I	Gypsy	LTR
Gypsy-4_DWil-LTR	Gypsy	LTR
Gypsy-40_DAn-I	Gypsy	LTR
Gypsy-40_DAn-LTR	Gypsy	LTR
Gypsy-40_DEl-I	Gypsy	LTR
Gypsy-40_DWil-LTR	Gypsy	LTR
Gypsy-41_DAn-I	Gypsy	LTR
Gypsy-41_DAn-LTR	Gypsy	LTR
Gypsy-41_DEl-I	Gypsy	LTR
Gypsy-41_DWil-LTR	Gypsy	LTR
Gypsy-42_DAn-I	Gypsy	LTR
Gypsy-42_DAn-LTR	Gypsy	LTR
Gypsy-42_DEl-I	Gypsy	LTR
Gypsy-42_DWil-I	Gypsy	LTR
Gypsy-42_DWil-LTR	Gypsy	LTR
Gypsy-43_DEl-I	Gypsy	LTR
Gypsy-43_DWil-I	Gypsy	LTR
Gypsy-43_DWil-LTR	Gypsy	LTR
Gypsy-44_DEl-I	Gypsy	LTR
Gypsy-44_DEl-LTR	Gypsy	LTR
Gypsy-44_DWil-I	Gypsy	LTR
Gypsy-44_DWil-LTR	Gypsy	LTR
Gypsy-45_DEl-I	Gypsy	LTR
Gypsy-45_DEl-LTR	Gypsy	LTR
Gypsy-45_DWil-I	Gypsy	LTR
Gypsy-45_DWil-LTR	Gypsy	LTR
Gypsy-46_DEl-I	Gypsy	LTR
Gypsy-46_DEl-LTR	Gypsy	LTR
Gypsy-46_DWil-I	Gypsy	LTR
Gypsy-46_DWil-LTR	Gypsy	LTR
Gypsy-47_DEl-I	Gypsy	LTR
Gypsy-47_DWil-I	Gypsy	LTR
Gypsy-47_DWil-LTR	Gypsy	LTR
Gypsy-48_DEl-I	Gypsy	LTR
Gypsy-48_DEl-LTR	Gypsy	LTR
Gypsy-48_DWil-I	Gypsy	LTR
Gypsy-48_DWil-LTR	Gypsy	LTR
Gypsy-49_DEl-I	Gypsy	LTR
Gypsy-49_DWil-I	Gypsy	LTR
Gypsy-49_DWil-LTR	Gypsy	LTR
Gypsy-5_DAn-I	Gypsy	LTR
Gypsy-5_DAn-LTR	Gypsy	LTR
Gypsy-5_DBi-I	Gypsy	LTR
Gypsy-5_DBi-LTR	Gypsy	LTR
Gypsy-5_DBp-I	Gypsy	LTR
Gypsy-5_DBp-LTR	Gypsy	LTR
Gypsy-5_DEl-I	Gypsy	LTR
Gypsy-5_DEl-LTR	Gypsy	LTR
Gypsy-5_DEr-LTR	Gypsy	LTR
Gypsy-5_Deu-I	Gypsy	LTR
Gypsy-5_Deu-LTR	Gypsy	LTR
Gypsy-5_DFi-I	Gypsy	LTR
Gypsy-5_DFi-LTR	Gypsy	LTR
Gypsy-5_DGri-I	Gypsy	LTR
Gypsy-5_DGri-LTR	Gypsy	LTR
Gypsy-5_DKi-I	Gypsy	LTR
Gypsy-5_DKi-LTR	Gypsy	LTR
Gypsy-5_DPer-I	Gypsy	LTR
Gypsy-5_DPer-LTR	Gypsy	LTR
Gypsy-5_DRh-I	Gypsy	LTR
Gypsy-5_DRh-LTR	Gypsy	LTR
Gypsy-5_DSe-I	Gypsy	LTR
Gypsy-5_DSe-LTR	Gypsy	LTR
Gypsy-5_DSim-I	Gypsy	LTR
Gypsy-5_DSim-LTR	Gypsy	LTR
Gypsy-5_DTa-I	Gypsy	LTR
Gypsy-5_DTa-LTR	Gypsy	LTR
Gypsy-5_DVir-I	Gypsy	LTR
Gypsy-5_DVir-LTR	Gypsy	LTR
Gypsy-5_DWil-I	Gypsy	LTR
Gypsy-5_DWil-LTR	Gypsy	LTR
Gypsy-50_DWil-I	Gypsy	LTR
Gypsy-50_DWil-LTR	Gypsy	LTR
Gypsy-51_DEl-I	Gypsy	LTR
Gypsy-51_DWil-I	Gypsy	LTR
Gypsy-51_DWil-LTR	Gypsy	LTR
Gypsy-52_DEl-I	Gypsy	LTR
Gypsy-52_DWil-I	Gypsy	LTR
Gypsy-52_DWil-LTR	Gypsy	LTR
Gypsy-53_DEl-I	Gypsy	LTR
Gypsy-53_DWil-I	Gypsy	LTR
Gypsy-53_DWil-LTR	Gypsy	LTR
Gypsy-54_DEl-I	Gypsy	LTR
Gypsy-54_DEl-LTR	Gypsy	LTR
Gypsy-54_DWil-I	Gypsy	LTR
Gypsy-54_DWil-LTR	Gypsy	LTR
Gypsy-55_DEl-I	Gypsy	LTR
Gypsy-55_DWil-I	Gypsy	LTR
Gypsy-55_DWil-LTR	Gypsy	LTR
Gypsy-56_DEl-LTR	Gypsy	LTR
Gypsy-56_DWil-I	Gypsy	LTR
Gypsy-56_DWil-LTR	Gypsy	LTR
Gypsy-57_DEl-I	Gypsy	LTR
Gypsy-57_DEl-LTR	Gypsy	LTR
Gypsy-57_DWil-I	Gypsy	LTR
Gypsy-57_DWil-LTR	Gypsy	LTR
Gypsy-58_DWil-I	Gypsy	LTR
Gypsy-58_DWil-LTR	Gypsy	LTR
Gypsy-59_DWil-I	Gypsy	LTR
Gypsy-59_DWil-LTR	Gypsy	LTR
Gypsy-6_DAn-I	Gypsy	LTR
Gypsy-6_DAn-LTR	Gypsy	LTR
Gypsy-6_DBi-I	Gypsy	LTR
Gypsy-6_DBi-LTR	Gypsy	LTR
Gypsy-6_DBp-I	Gypsy	LTR
Gypsy-6_DBp-LTR	Gypsy	LTR
Gypsy-6_DEl-I	Gypsy	LTR
Gypsy-6_DEl-LTR	Gypsy	LTR
Gypsy-6_DEu-I	Gypsy	LTR
Gypsy-6_DEu-LTR	Gypsy	LTR
Gypsy-6_DFi-I	Gypsy	LTR
Gypsy-6_DFi-LTR	Gypsy	LTR
Gypsy-6_DGri-I	Gypsy	LTR
Gypsy-6_DGri-LTR	Gypsy	LTR
Gypsy-6_DPer-I	Gypsy	LTR
Gypsy-6_DPer-LTR	Gypsy	LTR
Gypsy-6_DRh-I	Gypsy	LTR
Gypsy-6_DRh-LTR	Gypsy	LTR
Gypsy-6_DSe-I	Gypsy	LTR
Gypsy-6_DSe-LTR	Gypsy	LTR
Gypsy-6_DSim-I	Gypsy	LTR
Gypsy-6_DSim-LTR	Gypsy	LTR
Gypsy-6_DTa-I	Gypsy	LTR
Gypsy-6_DTa-LTR	Gypsy	LTR
Gypsy-6_DVir-I	Gypsy	LTR
Gypsy-6_DVir-LTR	Gypsy	LTR
Gypsy-6_DWil-I	Gypsy	LTR
Gypsy-6_DWil-LTR	Gypsy	LTR
Gypsy-60_DWil-I	Gypsy	LTR
Gypsy-60_DWil-LTR	Gypsy	LTR
Gypsy-61_DWil-I	Gypsy	LTR
Gypsy-61_DWil-LTR	Gypsy	LTR
Gypsy-62_DWil-I	Gypsy	LTR
Gypsy-62_DWil-LTR	Gypsy	LTR
Gypsy-63_DWil-I	Gypsy	LTR
Gypsy-63_DWil-LTR	Gypsy	LTR
Gypsy-64_DWil-I	Gypsy	LTR
Gypsy-64_DWil-LTR	Gypsy	LTR
Gypsy-7_DAn-I	Gypsy	LTR
Gypsy-7_DAn-LTR	Gypsy	LTR
Gypsy-7_DBi-I	Gypsy	LTR
Gypsy-7_DBi-LTR	Gypsy	LTR
Gypsy-7_DBp-I	Gypsy	LTR
Gypsy-7_DBp-LTR	Gypsy	LTR
Gypsy-7_DEl-I	Gypsy	LTR
Gypsy-7_DEl-LTR	Gypsy	LTR
Gypsy-7_DEu-I	Gypsy	LTR
Gypsy-7_DEu-LTR	Gypsy	LTR
Gypsy-7_DFi-I	Gypsy	LTR
Gypsy-7_DFi-LTR	Gypsy	LTR
Gypsy-7_DPer-I	Gypsy	LTR
Gypsy-7_DPer-LTR	Gypsy	LTR
Gypsy-7_DRh-I	Gypsy	LTR
Gypsy-7_DRh-LTR	Gypsy	LTR
Gypsy-7_DSe-I	Gypsy	LTR
Gypsy-7_DSe-LTR	Gypsy	LTR
Gypsy-7_DSim-I	Gypsy	LTR
Gypsy-7_DSim-LTR	Gypsy	LTR
Gypsy-7_DTa-I	Gypsy	LTR
Gypsy-7_DTa-LTR	Gypsy	LTR
Gypsy-7_DVir-I	Gypsy	LTR
Gypsy-7_DVir-LTR	Gypsy	LTR
Gypsy-7_DWil-I	Gypsy	LTR
Gypsy-7_DWil-LTR	Gypsy	LTR
Gypsy-8_DAn-I	Gypsy	LTR
Gypsy-8_DAn-LTR	Gypsy	LTR
Gypsy-8_DBi-I	Gypsy	LTR
Gypsy-8_DBi-LTR	Gypsy	LTR
Gypsy-8_DBp-I	Gypsy	LTR
Gypsy-8_DBp-LTR	Gypsy	LTR
Gypsy-8_DEl-I	Gypsy	LTR
Gypsy-8_DEl-LTR	Gypsy	LTR
Gypsy-8_DEu-I	Gypsy	LTR
Gypsy-8_DEu-LTR	Gypsy	LTR
Gypsy-8_DFi-I	Gypsy	LTR
Gypsy-8_DFi-LTR	Gypsy	LTR
Gypsy-8_DMoj-I	Gypsy	LTR
Gypsy-8_DMoj-LTR	Gypsy	LTR
Gypsy-8_DPer-I	Gypsy	LTR
Gypsy-8_DPer-LTR	Gypsy	LTR
Gypsy-8_DRh-I	Gypsy	LTR
Gypsy-8_DRh-LTR	Gypsy	LTR
Gypsy-8_DSe-I	Gypsy	LTR
Gypsy-8_DSe-LTR	Gypsy	LTR
Gypsy-8_DSim-I	Gypsy	LTR
Gypsy-8_DTa-I	Gypsy	LTR
Gypsy-8_DTa-LTR	Gypsy	LTR
Gypsy-8_DVir-I	Gypsy	LTR
Gypsy-8_DVir-LTR	Gypsy	LTR
Gypsy-8_DWil-I	Gypsy	LTR
Gypsy-8_DWil-LTR	Gypsy	LTR
Gypsy-9_DAn-I	Gypsy	LTR
Gypsy-9_DAn-LTR	Gypsy	LTR
Gypsy-9_DBi-I	Gypsy	LTR
Gypsy-9_DBi-LTR	Gypsy	LTR
Gypsy-9_DBp-I	Gypsy	LTR
Gypsy-9_DBp-LTR	Gypsy	LTR
Gypsy-9_DEl-I	Gypsy	LTR
Gypsy-9_DEl-LTR	Gypsy	LTR
Gypsy-9_DEu-I	Gypsy	LTR
Gypsy-9_DEu-LTR	Gypsy	LTR
Gypsy-9_DFi-I	Gypsy	LTR
Gypsy-9_DFi-LTR	Gypsy	LTR
Gypsy-9_DMoj-I	Gypsy	LTR
Gypsy-9_DMoj-LTR	Gypsy	LTR
Gypsy-9_DPer-I	Gypsy	LTR
Gypsy-9_DPer-LTR	Gypsy	LTR
Gypsy-9_DRh-I	Gypsy	LTR
Gypsy-9_DRh-LTR	Gypsy	LTR
Gypsy-9_DSim-I	Gypsy	LTR
Gypsy-9_DSim-LTR	Gypsy	LTR
Gypsy-9_DTa-I	Gypsy	LTR
Gypsy-9_DTa-LTR	Gypsy	LTR
Gypsy-9_DVir-I	Gypsy	LTR
Gypsy-9_DVir-LTR	Gypsy	LTR
Gypsy-9_DWil-I	Gypsy	LTR
Gypsy-9_DWil-LTR	Gypsy	LTR
Gypsy1-I_DM	Gypsy	LTR
Gypsy1-I_Dmoj	Gypsy	LTR
Gypsy1-I_Dpse	Gypsy	LTR
Gypsy1-I_DV	Gypsy	LTR
Gypsy1-I_Dya	Gypsy	LTR
Gypsy1-LTR_DM	Gypsy	LTR
Gypsy1-LTR_Dmoj	Gypsy	LTR
Gypsy1-LTR_Dpse	Gypsy	LTR
Gypsy1-LTR_DV	Gypsy	LTR
Gypsy1-LTR_Dya	Gypsy	LTR
Gypsy10_I	Gypsy	LTR
Gypsy10_LTR	Gypsy	LTR
Gypsy10-I_Dpse	Gypsy	LTR
Gypsy10-I_Dya	Gypsy	LTR
Gypsy10-LTR_Dpse	Gypsy	LTR
Gypsy10-LTR_Dya	Gypsy	LTR
Gypsy11_I	Gypsy	LTR
Gypsy11_LTR	Gypsy	LTR
Gypsy11-I_Dpse	Gypsy	LTR
Gypsy11-I_Dya	Gypsy	LTR
Gypsy11-LTR_Dpse	Gypsy	LTR
Gypsy11-LTR_Dya	Gypsy	LTR
Gypsy12_I	Gypsy	LTR
Gypsy12_LTR	Gypsy	LTR
Gypsy12-I_Dpse	Gypsy	LTR
Gypsy12-I_Dya	Gypsy	LTR
Gypsy12-LTR_Dpse	Gypsy	LTR
Gypsy12-LTR_Dya	Gypsy	LTR
Gypsy12A_LTR	Gypsy	LTR
Gypsy13-I_Dpse	Gypsy	LTR
Gypsy13-I_Dya	Gypsy	LTR
Gypsy13-LTR_Dpse	Gypsy	LTR
Gypsy13-LTR_Dya	Gypsy	LTR
Gypsy14-I_Dpse	Gypsy	LTR
Gypsy14-I_Dya	Gypsy	LTR
Gypsy14-LTR_Dpse	Gypsy	LTR
Gypsy14-LTR_Dya	Gypsy	LTR
Gypsy15-I_Dpse	Gypsy	LTR
Gypsy15-I_Dya	Gypsy	LTR
Gypsy15-LTR_Dpse	Gypsy	LTR
Gypsy15-LTR_Dya	Gypsy	LTR
Gypsy16-I_Dpse	Gypsy	LTR
Gypsy16-I_Dya	Gypsy	LTR
Gypsy16-LTR_Dpse	Gypsy	LTR
Gypsy16-LTR_Dya	Gypsy	LTR
Gypsy17-I_Dpse	Gypsy	LTR
Gypsy17-I_Dya	Gypsy	LTR
Gypsy17-LTR_Dpse	Gypsy	LTR
Gypsy17-LTR_Dya	Gypsy	LTR
Gypsy18-I_Dpse	Gypsy	LTR
Gypsy18-I_Dya	Gypsy	LTR
Gypsy18-LTR_Dpse	Gypsy	LTR
Gypsy18-LTR_Dya	Gypsy	LTR
Gypsy19-I_Dpse	Gypsy	LTR
Gypsy19-I_Dya	Gypsy	LTR
Gypsy19-LTR_Dpse	Gypsy	LTR
Gypsy19-LTR_Dya	Gypsy	LTR
Gypsy2_I	Gypsy	LTR
Gypsy2_LTR	Gypsy	LTR
Gypsy2-I_DM	Gypsy	LTR
Gypsy2-I_Dmoj	Gypsy	LTR
Gypsy2-I_Dpse	Gypsy	LTR
Gypsy2-I_DV	Gypsy	LTR
Gypsy2-I_Dya	Gypsy	LTR
Gypsy2-LTR_DM	Gypsy	LTR
Gypsy2-LTR_Dmoj	Gypsy	LTR
Gypsy2-LTR_Dpse	Gypsy	LTR
Gypsy2-LTR_DV	Gypsy	LTR
Gypsy2-LTR_Dya	Gypsy	LTR
Gypsy20-I_Dpse	Gypsy	LTR
Gypsy20-I_Dya	Gypsy	LTR
Gypsy20-LTR_Dpse	Gypsy	LTR
Gypsy20-LTR_Dya	Gypsy	LTR
Gypsy21-I_Dpse	Gypsy	LTR
Gypsy21-LTR_Dpse	Gypsy	LTR
Gypsy22-I_Dpse	Gypsy	LTR
Gypsy22-LTR_Dpse	Gypsy	LTR
Gypsy23-I_Dpse	Gypsy	LTR
Gypsy23-LTR_Dpse	Gypsy	LTR
Gypsy24-I_Dpse	Gypsy	LTR
Gypsy24-LTR_Dpse	Gypsy	LTR
Gypsy3_DV-I	Gypsy	LTR
Gypsy3_DV-LTR	Gypsy	LTR
Gypsy3_I	Gypsy	LTR
Gypsy3_LTR	Gypsy	LTR
Gypsy3-I_Dmoj	Gypsy	LTR
Gypsy3-I_Dpse	Gypsy	LTR
Gypsy3-I_Dya	Gypsy	LTR
Gypsy3-LTR_Dmoj	Gypsy	LTR
Gypsy3-LTR_Dpse	Gypsy	LTR
Gypsy3-LTR_Dya	Gypsy	LTR
Gypsy4_I	Gypsy	LTR
Gypsy4_LTR	Gypsy	LTR
Gypsy4-I_Dmoj	Gypsy	LTR
Gypsy4-I_Dpse	Gypsy	LTR
Gypsy4-I_Dya	Gypsy	LTR
Gypsy4-LTR_Dmoj	Gypsy	LTR
Gypsy4-LTR_Dpse	Gypsy	LTR
Gypsy4-LTR_Dya	Gypsy	LTR
Gypsy5_I	Gypsy	LTR
Gypsy5_LTR	Gypsy	LTR
Gypsy5-I_Dmoj	Gypsy	LTR
Gypsy5-I_Dpse	Gypsy	LTR
Gypsy5-I_Dya	Gypsy	LTR
Gypsy5-LTR_Dmoj	Gypsy	LTR
Gypsy5-LTR_Dpse	Gypsy	LTR
Gypsy5-LTR_Dya	Gypsy	LTR
Gypsy6_I	Gypsy	LTR
Gypsy6_LTR	Gypsy	LTR
Gypsy6-I_Dmoj	Gypsy	LTR
Gypsy6-I_Dpse	Gypsy	LTR
Gypsy6-I_Dya	Gypsy	LTR
Gypsy6-LTR_Dmoj	Gypsy	LTR
Gypsy6-LTR_Dpse	Gypsy	LTR
Gypsy6-LTR_Dya	Gypsy	LTR
Gypsy6A_LTR	Gypsy	LTR
Gypsy7_I	Gypsy	LTR
Gypsy7_LTR	Gypsy	LTR
Gypsy7-I_Dmoj	Gypsy	LTR
Gypsy7-I_Dpse	Gypsy	LTR
Gypsy7-I_Dya	Gypsy	LTR
Gypsy7-LTR_Dmoj	Gypsy	LTR
Gypsy7-LTR_Dpse	Gypsy	LTR
Gypsy7-LTR_Dya	Gypsy	LTR
Gypsy8_I	Gypsy	LTR
Gypsy8_LTR	Gypsy	LTR
Gypsy8-I_Dpse	Gypsy	LTR
Gypsy8-I_Dya	Gypsy	LTR
Gypsy8-LTR_Dpse	Gypsy	LTR
Gypsy8-LTR_Dya	Gypsy	LTR
Gypsy9_I	Gypsy	LTR
Gypsy9_LTR	Gypsy	LTR
Gypsy9-I_Dpse	Gypsy	LTR
Gypsy9-I_Dya	Gypsy	LTR
Gypsy9-LTR_Dpse	Gypsy	LTR
Gypsy9-LTR_Dya	Gypsy	LTR
Gypsy	Gypsy	LTR
Gypsy1_DM	Gypsy	LTR
Gypsy-24_DYa	Gypsy	LTR
Gypsy11	Gypsy	LTR
Gypsy-26_DYa	Gypsy	LTR
Gypsy6	Gypsy	LTR
Gypsy5	Gypsy	LTR
Gypsy-4_DSim	Gypsy	LTR
Gypsy-1_DSim	Gypsy	LTR
Gypsy8	Gypsy	LTR
Gypsy4	Gypsy	LTR
Gypsy12	Gypsy	LTR
Gypsy20_Dya	Gypsy	LTR
Gypsy2_DM	Gypsy	LTR
Gypsy9	Gypsy	LTR
Gypsy-8_DEl	Gypsy	LTR
Gypsy10	Gypsy	LTR
Gypsy2	Gypsy	LTR
Gypsy7	Gypsy	LTR
Gypsy-6_DSe	Gypsy	LTR
Gypsy3	Gypsy	LTR
Gypsy5	Gypsy	LTR
Gypsy-4_DSim	Gypsy	LTR
Gypsy7	Gypsy	LTR
Harbinger-1_DF	PIF-Harbinger	DNA
Harbinger-1_DK	PIF-Harbinger	DNA
Harbinger-1_DRh	PIF-Harbinger	DNA
Harbinger-1_DW	PIF-Harbinger	DNA
Harbinger-1N1_DF	PIF-Harbinger	DNA
Harbinger-1N1_DK	PIF-Harbinger	DNA
Harbinger-1N1_DRh	PIF-Harbinger	DNA
Harbinger-2_DRh	PIF-Harbinger	DNA
Harbinger-2B_DRh	PIF-Harbinger	DNA
Harbinger-N1_DPe	PIF-Harbinger	DNA
Harbinger1_DYa	PIF-Harbinger	DNA
hAT-1_DAn	hAT-Charlie	DNA
hAT-1_DBp	hAT-Blackjack	DNA
hAT-1_DEl	hAT-Ac	DNA
hAT-1_DF	hAT-hobo	DNA
hAT-1_DK	hAT-Ac	DNA
hAT-1_DP	hAT-Ac	DNA
hAT-1_DRh	hAT-Ac	DNA
hAT-1_DSi	hAT-Ac	DNA
hAT-1_DT	hAT-Pegasus	DNA
hAT-10_DBp	hAT-hobo	DNA
hAT-1N_DP	hAT	DNA
hAT-1N_DW	hAT-hobo	DNA
hAT-2_DBp	hAT-Ac	DNA
hAT-2_DF	hAT-hobo	DNA
hAT-2_DK	hAT-Ac	DNA
hAT-2_DRh	hAT-hobo	DNA
hAT-2_DSe	hAT-Ac	DNA
hAT-2_DT	hAT-hobo	DNA
hAT-2_DY	hAT-hobo	DNA
hAT-2N1_DF	hAT-hobo	DNA
hAT-3_DBp	hAT-Ac	DNA
hAT-3_DF	hAT-Ac	DNA
hAT-3_DK	hAT-Ac	DNA
hAT-3_DRh	hAT-hobo	DNA
hAT-3_DT	hAT-hobo	DNA
hAT-4_DBp	hAT-Ac	DNA
hAT-4_DK	hAT-hobo	DNA
hAT-4_DRh	hAT-hobo	DNA
hAT-5_DBp	hAT-Ac	DNA
hAT-5_DK	hAT-hobo	DNA
hAT-5_DRh	hAT-Ac	DNA
hAT-5N1_DK	hAT-hobo	DNA
hAT-5N1_DRh	hAT-Ac	DNA
hAT-6_DBp	hAT-hobo	DNA
hAT-6_DK	hAT-hobo	DNA
hAT-6_DRh	hAT-Ac	DNA
hAT-7_DBp	hAT-hobo	DNA
hAT-8_DBp	hAT-hobo	DNA
hAT-9_DBp	hAT-Pegasus	DNA
hAT-N1_DBp	hAT-Ac	DNA
hAT-N1_DEl	hAT-Ac	DNA
hAT-N1_DK	hAT-Ac	DNA
hAT-N1B_DBp	hAT-Ac	DNA
HELENA	Jockey	Non-LTR_retrotransposon
Helena_Ds	Jockey	Non-LTR_retrotransposon
HELENA_RT	Jockey	Non-LTR_retrotransposon
Helitron-1_DAna	Helitron	RC
Helitron-1_DBp	Helitron	RC
Helitron-1_DEl	Helitron	RC
Helitron-1_DEu	Helitron	RC
Helitron-1_DF	Helitron	RC
Helitron-1_DK	Helitron	RC
Helitron-1_DPe	Helitron	RC
Helitron-1_DT	Helitron	RC
Helitron-1_DVir	Helitron	RC
Helitron-1_DYak	Helitron	RC
Helitron-1N_DF	Helitron	RC
Helitron-1N1_DVir	Helitron	RC
Helitron-2_DBp	Helitron	RC
Helitron-2_DF	Helitron	RC
Helitron-2_DRh	Helitron	RC
Helitron-2_DVir	Helitron	RC
Helitron-2N_DW	Helitron	RC
Helitron-2N1_DVir	Helitron	RC
Helitron-3_DRh	Helitron	RC
Helitron-4_DRh	Helitron	RC
Helitron-5_DRh	Helitron	RC
Helitron-6_DRh	Helitron	RC
Helitron-7_DRh	Helitron	RC
Helitron-8_DRh	Helitron	RC
Helitron-9_DRh	Helitron	RC
Helitron-N1_DAn	Helitron	RC
Helitron-N1_DBi	Helitron	RC
Helitron-N1_DBp	Helitron	RC
Helitron-N1_DEl	Helitron	RC
Helitron-N2_DBi	Helitron	RC
Helitron-N2_DBp	Helitron	RC
Helitron-N2_DEl	Helitron	RC
Helitron-N2_DT	Helitron	RC
Helitron-N3_DT	Helitron	RC
Helitron1_DM	Helitron	RC
Helitron1_Dmoj	Helitron	RC
HelitronN-1_DPe	Helitron	RC
HET-A_DV	Jockey	Non-LTR_retrotransposon
HeT-A2_DVi	Jockey	Non-LTR_retrotransposon
HeT-A3_DVi	Jockey	Non-LTR_retrotransposon
HETA	Jockey	Non-LTR_retrotransposon
HETA_DSi	Jockey	Non-LTR_retrotransposon
Heta-1_D	Jockey	Non-LTR_retrotransposon
Heta-3	Jockey	Non-LTR_retrotransposon
Heta-5	Jockey	Non-LTR_retrotransposon
Heta-2	Jockey	Non-LTR_retrotransposon
HETRP_DM	Satellite	Satellite
HMSBEAGLE_I	Gypsy	LTR
Hoana1	hAT-hobo	DNA
Hoana2	hAT-Ac	DNA
Hoana3	hAT-hobo	DNA
Hoana4	hAT-hobo	DNA
Hoana5	hAT-Ac	DNA
Hoana6	hAT-Ac	DNA
Hoana7	hAT-Ac	DNA
Hoana8	hAT-hobo	DNA
HOBO	hAT-hobo	DNA
Hogri1	hAT-hobo	DNA
Homo1	hAT-hobo	DNA
Homo10	hAT-Ac	DNA
Homo11	hAT-hobo	DNA
Homo2	hAT-Ac	DNA
Homo3	hAT-Ac	DNA
Homo4	hAT-hobo	DNA
Homo5	hAT-Ac	DNA
Homo6	hAT-Pegasus	DNA
Homo7	hAT-Ac	DNA
Homo8	hAT-Ac	DNA
Homo9	hAT-Ac	DNA
Hopers2	hAT-hobo	DNA
Hopers3	hAT-Pegasus	DNA
Hopseu2	hAT-Pegasus	DNA
Hovi1	hAT-hobo	DNA
Hovi2	hAT-hobo	DNA
Howilli1	hAT-Ac	DNA
Howilli2	hAT-hobo	DNA
Howilli3	hAT-Ac	DNA
Howilli4	hAT-hobo	DNA
Howilli5	hAT-hobo	DNA
Hoyak1	hAT-hobo	DNA
Hoyak2	hAT-Ac	DNA
Hoyak3	hAT-Pegasus	DNA
I_DM	I	Non-LTR_retrotransposon
I-1_DAn	I	Non-LTR_retrotransposon
I-1_DBi	I	Non-LTR_retrotransposon
I-1_DBp	I	Non-LTR_retrotransposon
I-1_DEl	I	Non-LTR_retrotransposon
I-1_DEu	I	Non-LTR_retrotransposon
I-1_DF	I	Non-LTR_retrotransposon
I-1_DK	I	Non-LTR_retrotransposon
I-1_DPe	I	Non-LTR_retrotransposon
I-1_DT	I	Non-LTR_retrotransposon
I-1_DVi	I	Non-LTR_retrotransposon
I-1_DWi	I	Non-LTR_retrotransposon
I-1_DYa	I	Non-LTR_retrotransposon
I-10_DBi	I	Non-LTR_retrotransposon
I-2_DAn	I	Non-LTR_retrotransposon
I-2_DBi	I	Non-LTR_retrotransposon
I-2_DBp	I	Non-LTR_retrotransposon
I-2_DEl	I	Non-LTR_retrotransposon
I-2_DEu	I	Non-LTR_retrotransposon
I-2_DF	I	Non-LTR_retrotransposon
I-2_DK	I	Non-LTR_retrotransposon
I-2_DVi	I	Non-LTR_retrotransposon
I-2_DWi	I	Non-LTR_retrotransposon
I-2_DYa	I	Non-LTR_retrotransposon
I-3_DAn	I	Non-LTR_retrotransposon
I-3_DBi	I	Non-LTR_retrotransposon
I-3_DBp	I	Non-LTR_retrotransposon
I-3_DEu	I	Non-LTR_retrotransposon
I-3_DF	I	Non-LTR_retrotransposon
I-3_DK	I	Non-LTR_retrotransposon
I-3_DYa	I	Non-LTR_retrotransposon
I-4_DAn	I	Non-LTR_retrotransposon
I-4_DBi	I	Non-LTR_retrotransposon
I-4_DBp	I	Non-LTR_retrotransposon
I-4_DEu	I	Non-LTR_retrotransposon
I-4_DF	I	Non-LTR_retrotransposon
I-4_DK	I	Non-LTR_retrotransposon
I-4_DYa	I	Non-LTR_retrotransposon
I-5_DBi	I	Non-LTR_retrotransposon
I-5_DBp	I	Non-LTR_retrotransposon
I-5_DF	I	Non-LTR_retrotransposon
I-5_DK	I	Non-LTR_retrotransposon
I-6_DBi	I	Non-LTR_retrotransposon
I-6_DBp	I	Non-LTR_retrotransposon
I-6_DF	I	Non-LTR_retrotransposon
I-6_DY	I	Non-LTR_retrotransposon
I-7_DBi	I	Non-LTR_retrotransposon
I-7_DBp	I	Non-LTR_retrotransposon
I-8_DBi	I	Non-LTR_retrotransposon
I-8_DBp	I	Non-LTR_retrotransposon
IDEFIX_I	Gypsy	LTR
IDEFIX_LTR	Gypsy	LTR
IDEFIX	Gypsy	LTR
INV2j_DB	P	DNA
Invader1_I	Gypsy	LTR
Invader1_LTR	Gypsy	LTR
Invader2_I	Gypsy	LTR
Invader2_LTR	Gypsy	LTR
Invader3_I	Gypsy	LTR
Invader3_LTR	Gypsy	LTR
Invader4_I	Gypsy	LTR
Invader4_LTR	Gypsy	LTR
Invader5_I	Gypsy	LTR
Invader5_LTR	Gypsy	LTR
Invader6_I	Gypsy	LTR
Invader6_LTR	Gypsy	LTR
Invader4	Gypsy	LTR
Invader2	Gypsy	LTR
Invader3	Gypsy	LTR
Invader5	Gypsy	LTR
Invader6	Gypsy	LTR
Invader1	Gypsy	LTR
ISFUN1	Helitron	RC
IVK_DM	I	Non-LTR_retrotransposon
Jockey-1_DAn	Jockey	Non-LTR_retrotransposon
Jockey-1_DBi	Jockey	Non-LTR_retrotransposon
Jockey-1_DBp	Jockey	Non-LTR_retrotransposon
Jockey-1_DEl	Jockey	Non-LTR_retrotransposon
Jockey-1_DEr	Jockey	Non-LTR_retrotransposon
Jockey-1_DEu	Jockey	Non-LTR_retrotransposon
Jockey-1_DF	Jockey	Non-LTR_retrotransposon
Jockey-1_DGri	Jockey	Non-LTR_retrotransposon
Jockey-1_DK	Jockey	Non-LTR_retrotransposon
Jockey-1_DPer	Jockey	Non-LTR_retrotransposon
Jockey-1_DRh	Jockey	Non-LTR_retrotransposon
Jockey-1_Dro	Jockey	Non-LTR_retrotransposon
Jockey-1_DSe	Jockey	Non-LTR_retrotransposon
Jockey-1_DSi	Jockey	Non-LTR_retrotransposon
Jockey-1_DT	Jockey	Non-LTR_retrotransposon
Jockey-1_DVi	Jockey	Non-LTR_retrotransposon
Jockey-1_DWi	Jockey	Non-LTR_retrotransposon
Jockey-1_DYa	Jockey	Non-LTR_retrotransposon
Jockey-10_DAn	Jockey	Non-LTR_retrotransposon
Jockey-10_DBp	Jockey	Non-LTR_retrotransposon
Jockey-10_DEu	Jockey	Non-LTR_retrotransposon
Jockey-10_DF	Jockey	Non-LTR_retrotransposon
Jockey-10_DRh	Jockey	Non-LTR_retrotransposon
Jockey-10_DY	Jockey	Non-LTR_retrotransposon
Jockey-11_DAn	Jockey	Non-LTR_retrotransposon
Jockey-11_DBp	Jockey	Non-LTR_retrotransposon
Jockey-11_DF	Jockey	Non-LTR_retrotransposon
Jockey-11B_DBp	Jockey	Non-LTR_retrotransposon
Jockey-12_DAn	Jockey	Non-LTR_retrotransposon
Jockey-12_DBp	Jockey	Non-LTR_retrotransposon
Jockey-12_DF	Jockey	Non-LTR_retrotransposon
Jockey-13_DAn	Jockey	Non-LTR_retrotransposon
Jockey-13_DBp	Jockey	Non-LTR_retrotransposon
Jockey-14_DAn	Jockey	Non-LTR_retrotransposon
Jockey-14_DBp	Jockey	Non-LTR_retrotransposon
Jockey-15_DBp	Jockey	Non-LTR_retrotransposon
Jockey-2_DAn	Jockey	Non-LTR_retrotransposon
Jockey-2_DBi	Jockey	Non-LTR_retrotransposon
Jockey-2_DBp	Jockey	Non-LTR_retrotransposon
Jockey-2_DEl	Jockey	Non-LTR_retrotransposon
Jockey-2_DEu	Jockey	Non-LTR_retrotransposon
Jockey-2_DF	Jockey	Non-LTR_retrotransposon
Jockey-2_DGri	Jockey	Non-LTR_retrotransposon
Jockey-2_DK	Jockey	Non-LTR_retrotransposon
Jockey-2_DPer	Jockey	Non-LTR_retrotransposon
Jockey-2_DRh	Jockey	Non-LTR_retrotransposon
Jockey-2_DSim	Jockey	Non-LTR_retrotransposon
Jockey-2_DT	Jockey	Non-LTR_retrotransposon
Jockey-2_DVi	Jockey	Non-LTR_retrotransposon
Jockey-2_DYa	Jockey	Non-LTR_retrotransposon
Jockey-3_DAn	Jockey	Non-LTR_retrotransposon
Jockey-3_DBp	Jockey	Non-LTR_retrotransposon
Jockey-3_DEl	Jockey	Non-LTR_retrotransposon
Jockey-3_DEu	Jockey	Non-LTR_retrotransposon
Jockey-3_DF	Jockey	Non-LTR_retrotransposon
Jockey-3_DGri	Jockey	Non-LTR_retrotransposon
Jockey-3_DK	Jockey	Non-LTR_retrotransposon
Jockey-3_DM	Jockey	Non-LTR_retrotransposon
Jockey-3_DPer	Jockey	Non-LTR_retrotransposon
Jockey-3_DRh	Jockey	Non-LTR_retrotransposon
Jockey-3_DSim	Jockey	Non-LTR_retrotransposon
Jockey-3_DT	Jockey	Non-LTR_retrotransposon
Jockey-3_DVi	Jockey	Non-LTR_retrotransposon
Jockey-3_DYa	Jockey	Non-LTR_retrotransposon
Jockey-4_DAn	Jockey	Non-LTR_retrotransposon
Jockey-4_DBp	Jockey	Non-LTR_retrotransposon
Jockey-4_DEl	Jockey	Non-LTR_retrotransposon
Jockey-4_DEu	Jockey	Non-LTR_retrotransposon
Jockey-4_DF	Jockey	Non-LTR_retrotransposon
Jockey-4_DK	Jockey	Non-LTR_retrotransposon
Jockey-4_DPer	Jockey	Non-LTR_retrotransposon
Jockey-4_DRh	Jockey	Non-LTR_retrotransposon
Jockey-4_DSim	Jockey	Non-LTR_retrotransposon
Jockey-4_DT	Jockey	Non-LTR_retrotransposon
Jockey-4_DVi	Jockey	Non-LTR_retrotransposon
Jockey-4_DYa	Jockey	Non-LTR_retrotransposon
Jockey-4B_DVi	Jockey	Non-LTR_retrotransposon
Jockey-5_DAn	Jockey	Non-LTR_retrotransposon
Jockey-5_DBp	Jockey	Non-LTR_retrotransposon
Jockey-5_DEl	Jockey	Non-LTR_retrotransposon
Jockey-5_DEu	Jockey	Non-LTR_retrotransposon
Jockey-5_DF	Jockey	Non-LTR_retrotransposon
Jockey-5_DK	Jockey	Non-LTR_retrotransposon
Jockey-5_DPer	Jockey	Non-LTR_retrotransposon
Jockey-5_DTa	Jockey	Non-LTR_retrotransposon
Jockey-5_DVi	Jockey	Non-LTR_retrotransposon
Jockey-5_DYa	Jockey	Non-LTR_retrotransposon
Jockey-6_DAn	Jockey	Non-LTR_retrotransposon
Jockey-6_DBp	Jockey	Non-LTR_retrotransposon
Jockey-6_DEl	Jockey	Non-LTR_retrotransposon
Jockey-6_DEu	Jockey	Non-LTR_retrotransposon
Jockey-6_DF	Jockey	Non-LTR_retrotransposon
Jockey-6_DK	Jockey	Non-LTR_retrotransposon
Jockey-6_DPer	Jockey	Non-LTR_retrotransposon
Jockey-6_DRh	Jockey	Non-LTR_retrotransposon
Jockey-6_DVi	Jockey	Non-LTR_retrotransposon
Jockey-6_DYa	Jockey	Non-LTR_retrotransposon
Jockey-7_DAn	Jockey	Non-LTR_retrotransposon
Jockey-7_DEl	Jockey	Non-LTR_retrotransposon
Jockey-7_DEu	Jockey	Non-LTR_retrotransposon
Jockey-7_DF	Jockey	Non-LTR_retrotransposon
Jockey-7_DK	Jockey	Non-LTR_retrotransposon
Jockey-7_DPer	Jockey	Non-LTR_retrotransposon
Jockey-7_DRh	Jockey	Non-LTR_retrotransposon
Jockey-7_DVi	Jockey	Non-LTR_retrotransposon
Jockey-7_DYa	Jockey	Non-LTR_retrotransposon
Jockey-8_DAn	Jockey	Non-LTR_retrotransposon
Jockey-8_DEu	Jockey	Non-LTR_retrotransposon
Jockey-8_DF	Jockey	Non-LTR_retrotransposon
Jockey-8_DPer	Jockey	Non-LTR_retrotransposon
Jockey-8_DRh	Jockey	Non-LTR_retrotransposon
Jockey-8_DVi	Jockey	Non-LTR_retrotransposon
Jockey-8_DYa	Jockey	Non-LTR_retrotransposon
Jockey-9_DAn	Jockey	Non-LTR_retrotransposon
Jockey-9_DBp	Jockey	Non-LTR_retrotransposon
Jockey-9_DEu	Jockey	Non-LTR_retrotransposon
Jockey-9_DF	Jockey	Non-LTR_retrotransposon
Jockey-9_DPer	Jockey	Non-LTR_retrotransposon
Jockey-9_DRh	Jockey	Non-LTR_retrotransposon
Jockey-9_DY	Jockey	Non-LTR_retrotransposon
Jockey-N1_DVi	Jockey	Non-LTR_retrotransposon
Jockey2	Jockey	Non-LTR_retrotransposon
Jockey-3_Dmel_08212020	Jockey	Non-LTR_retrotransposon
KBOC_DB	P	DNA
Kiri-1_DBi	L2	Non-LTR_retrotransposon
Kiri-1_DEl	L2	Non-LTR_retrotransposon
Kiri-1_DF	L2	Non-LTR_retrotransposon
Kiri-1_DK	L2	Non-LTR_retrotransposon
Kiri-1_DPer	L2	Non-LTR_retrotransposon
Kiri-1_DRh	Kiri	LTR
Kiri-1_DTa	L2	Non-LTR_retrotransposon
Kiri-2_DEl	L2	Non-LTR_retrotransposon
Kiri-2_DK	L2	Non-LTR_retrotransposon
Kiri-2_DPer	L2	Non-LTR_retrotransposon
Kiri-2_DTa	L2	Non-LTR_retrotransposon
Kiri-3_DK	L2	Non-LTR_retrotransposon
Kiri-3_DTa	L2	Non-LTR_retrotransposon
Kiri-4_DK	L2	Non-LTR_retrotransposon
Kiri-5_DK	L2	Non-LTR_retrotransposon
Kiri-6_DK	L2	Non-LTR_retrotransposon
Kolobok-1_DBp	Kolobok-Hydra	DNA
Kolobok-N1_DAn	Kolobok-Hydra	DNA
Kolobok-N1_DF	Kolobok-Hydra	DNA
L-Rsp_SAT	Rsp	Satellite
LINEJ1_DM	Jockey	Non-LTR_retrotransposon
LmeSINE1c	tRNA-Deu-L2	SINE
LOA	LOA	Non-LTR_retrotransposon
Loa-1_DAn	LOA	Non-LTR_retrotransposon
LOA-1_DBi	LOA	Non-LTR_retrotransposon
Loa-1_DBp	LOA	Non-LTR_retrotransposon
Loa-1_DEl	LOA	Non-LTR_retrotransposon
LOA-1_DGri	LOA	Non-LTR_retrotransposon
Loa-1_DK	LOA	Non-LTR_retrotransposon
LOA-1_DPer	LOA	Non-LTR_retrotransposon
Loa-1_DPs	LOA	Non-LTR_retrotransposon
Loa-1_DRh	LOA	Non-LTR_retrotransposon
Loa-1_DT	LOA	Non-LTR_retrotransposon
LOA-1_DYa	LOA	Non-LTR_retrotransposon
LOA-1B_DPer	LOA	Non-LTR_retrotransposon
Loa-1B_DT	LOA	Non-LTR_retrotransposon
Loa-1C_DT	LOA	Non-LTR_retrotransposon
Loa-2_DEl	LOA	Non-LTR_retrotransposon
Loa-2_DF	LOA	Non-LTR_retrotransposon
LOA-2_DGri	LOA	Non-LTR_retrotransposon
Loa-2_DK	LOA	Non-LTR_retrotransposon
LOA-2_DPer	LOA	Non-LTR_retrotransposon
Loa-2_DTa	LOA	Non-LTR_retrotransposon
LOA-2_DYa	LOA	Non-LTR_retrotransposon
Loa-3_DEl	LOA	Non-LTR_retrotransposon
LOA-3_DPer	LOA	Non-LTR_retrotransposon
Loa-3_DTa	LOA	Non-LTR_retrotransposon
LOOPER1_DM	PiggyBac	DNA
M4DM	CMC-Transib	DNA
MAR_DW	hAT	DNA
Mariner_DMA	TcMar-Mariner	DNA
Mariner-1_DAn	TcMar-Tc1	DNA
Mariner-1_DAr	TcMar-Mariner	DNA
Mariner-1_DBi	TcMar-Mariner	DNA
Mariner-1_DBp	TcMar-Tc1	DNA
Mariner-1_DEl	TcMar-Mariner	DNA
Mariner-1_DEr	TcMar-Mariner	DNA
Mariner-1_DEu	TcMar-Tc1	DNA
Mariner-1_DF	TcMar-Mariner	DNA
Mariner-1_DGr	TcMar-Tc1	DNA
Mariner-1_DK	TcMar-Tc1	DNA
Mariner-1_DMac	TcMar-Mariner	DNA
Mariner-1_DPe	TcMar-Mariner	DNA
Mariner-1_Dro	TcMar-Mariner	DNA
Mariner-1_DSim	TcMar-Tc1	DNA
Mariner-1_DT	TcMar-Tc1	DNA
Mariner-1_DVi	TcMar-Tc1	DNA
Mariner-1_DW	TcMar-Tc1	DNA
Mariner-10_DAn	TcMar-Tc1	DNA
Mariner-10_DBp	TcMar-Tc1	DNA
Mariner-10_DEl	TcMar-Tc1	DNA
Mariner-10_DF	TcMar-Tc1	DNA
Mariner-10_DK	TcMar-Tc1	DNA
Mariner-10_DRh	TcMar-Tc1	DNA
Mariner-11_DAn	TcMar-Tc1	DNA
Mariner-11_DBp	TcMar-Tc1	DNA
Mariner-11_DF	TcMar-Tc1	DNA
Mariner-11_DK	TcMar-Tc1	DNA
Mariner-11_DRh	TcMar-Tc1	DNA
Mariner-12_DAn	TcMar-Tc1	DNA
Mariner-12_DBp	TcMar-Tc1	DNA
Mariner-12_DF	TcMar-Tc1	DNA
Mariner-12_DK	TcMar-Tc1	DNA
Mariner-12_DRh	TcMar-Tc1	DNA
Mariner-13_DAn	TcMar-Tc1	DNA
Mariner-13_DBp	TcMar-Mariner	DNA
Mariner-13_DF	TcMar-Tc1	DNA
Mariner-13_DK	TcMar-Tc1	DNA
Mariner-13_DRh	TcMar-Tc1	DNA
Mariner-14_DAn	TcMar-Tc1	DNA
Mariner-14_DBp	TcMar-Mariner	DNA
Mariner-14_DF	TcMar-Tc1	DNA
Mariner-14_DK	TcMar-Tc1	DNA
Mariner-14_DRh	TcMar-Tc1	DNA
Mariner-15_DAn	TcMar-Tc1	DNA
Mariner-15_DF	TcMar-Tc1	DNA
Mariner-15_DK	TcMar-Tc1	DNA
Mariner-15_DRh	TcMar-Tc1	DNA
Mariner-16_DAn	TcMar-Tc1	DNA
Mariner-16_DF	TcMar-Tc1	DNA
Mariner-16_DK	TcMar-Tc1	DNA
Mariner-16_DRh	TcMar-Tc1	DNA
Mariner-17_DAn	TcMar-Tc1	DNA
Mariner-17_DF	TcMar-Tc1	DNA
Mariner-17_DK	TcMar-Tc1	DNA
Mariner-17_DRh	TcMar-Tc1	DNA
Mariner-18_DAn	TcMar-Tc1	DNA
Mariner-18_DF	TcMar-Tc1	DNA
Mariner-18_DK	TcMar-Tc1	DNA
Mariner-18_DRh	TcMar-Tc1	DNA
Mariner-19_DAn	TcMar-Tc1	DNA
Mariner-19_DF	TcMar-Tc1	DNA
Mariner-19_DK	TcMar-Tc1	DNA
Mariner-19_DRh	TcMar-Tc1	DNA
Mariner-2_DAn	TcMar-Tc1	DNA
Mariner-2_DBi	TcMar-Tc1	DNA
Mariner-2_DBp	TcMar-Tc1	DNA
Mariner-2_DEl	TcMar-Mariner	DNA
Mariner-2_DEr	TcMar-Mariner	DNA
Mariner-2_DEu	TcMar-Tc1	DNA
Mariner-2_DF	TcMar-Mariner	DNA
Mariner-2_DK	TcMar-Tc1	DNA
Mariner-2_DMac	TcMar-Mariner	DNA
Mariner-2_DRh	TcMar-Tc1	DNA
Mariner-2_Dro	TcMar-Mariner	DNA
Mariner-2_DT	TcMar-Tc1	DNA
Mariner-2_DVi	TcMar-Tc1	DNA
Mariner-2_DYa	TcMar-Tc1	DNA
Mariner-20_DAn	TcMar-Tc1	DNA
Mariner-20_DF	TcMar-Tc1	DNA
Mariner-20_DK	TcMar-Tc1	DNA
Mariner-20_DRh	TcMar-Tc1	DNA
Mariner-21_DF	TcMar-Tc1	DNA
Mariner-21_DK	TcMar-Tc1	DNA
Mariner-22_DF	TcMar-Tc1	DNA
Mariner-22_DK	TcMar-Tc1	DNA
Mariner-23_DF	TcMar-Tc1	DNA
Mariner-24_DF	TcMar-Tc1	DNA
Mariner-25_DF	TcMar-Tc1	DNA
Mariner-26_DF	TcMar-Tc1	DNA
Mariner-27_DF	TcMar-Tc1	DNA
Mariner-28_DF	TcMar-Tc1	DNA
Mariner-29_DF	TcMar-Mariner	DNA
Mariner-3_DAn	TcMar-Tc1	DNA
Mariner-3_DBi	TcMar-Tc1	DNA
Mariner-3_DBp	TcMar-Tc1	DNA
Mariner-3_DEl	TcMar-Tc1	DNA
Mariner-3_DEu	TcMar-Tc1	DNA
Mariner-3_DF	TcMar-Mariner	DNA
Mariner-3_DK	TcMar-Tc1	DNA
Mariner-3_DRh	TcMar-Mariner	DNA
Mariner-3_Dro	TcMar-Tc1	DNA
Mariner-3_DT	TcMar-Mariner	DNA
Mariner-3_DYa	TcMar-Tc1	DNA
Mariner-30_DF	TcMar-Tc1	DNA
Mariner-4_DAn	TcMar-Tc1	DNA
Mariner-4_DBi	TcMar-Mariner	DNA
Mariner-4_DBp	TcMar-Tc1	DNA
Mariner-4_DEu	TcMar-Tc1	DNA
Mariner-4_DF	TcMar-Tc1	DNA
Mariner-4_DK	TcMar-Tc1	DNA
Mariner-4_DRh	TcMar-Tc1	DNA
Mariner-4_DY	TcMar-Tc1	DNA
Mariner-5_DAn	TcMar-Tc1	DNA
Mariner-5_DBi	TcMar-Mariner	DNA
Mariner-5_DBp	TcMar-Tc1	DNA
Mariner-5_DEl	TcMar-Tc1	DNA
Mariner-5_DEu	TcMar-Tc1	DNA
Mariner-5_DF	TcMar-Tc1	DNA
Mariner-5_DK	TcMar-Tc1	DNA
Mariner-5_DRh	TcMar-Tc1	DNA
Mariner-5_DY	TcMar-Tc1	DNA
Mariner-6_DAn	TcMar-Tc1	DNA
Mariner-6_DBi	TcMar-Tc1	DNA
Mariner-6_DBp	TcMar-Tc1	DNA
Mariner-6_DEl	TcMar-Mariner	DNA
Mariner-6_DF	TcMar-Mariner	DNA
Mariner-6_DK	TcMar-Tc1	DNA
Mariner-6_DRh	TcMar-Tc1	DNA
Mariner-6_DY	TcMar-Tc1	DNA
Mariner-7_DAn	TcMar-Tc1	DNA
Mariner-7_DBi	TcMar-Tc1	DNA
Mariner-7_DBp	TcMar-Tc1	DNA
Mariner-7_DEl	TcMar-Mariner	DNA
Mariner-7_DF	TcMar-Tc1	DNA
Mariner-7_DK	TcMar-Tc1	DNA
Mariner-7_DRh	TcMar-Tc1	DNA
Mariner-7_DYa	TcMar-Tc1	DNA
Mariner-7N1_DEl	TcMar-Mariner	DNA
Mariner-8_DAn	TcMar-Tc1	DNA
Mariner-8_DBp	TcMar-Tc1	DNA
Mariner-8_DEl	TcMar-Mariner	DNA
Mariner-8_DF	TcMar-Tc1	DNA
Mariner-8_DK	TcMar-Mariner	DNA
Mariner-8_DRh	TcMar-Tc1	DNA
Mariner-9_DAn	TcMar-Tc1	DNA
Mariner-9_DBp	TcMar-Tc1	DNA
Mariner-9_DEl	TcMar-Tc1	DNA
Mariner-9_DF	TcMar-Tc1	DNA
Mariner-9_DK	TcMar-Tc1	DNA
Mariner-9_DRh	TcMar-Tc1	DNA
Mariner1_DYa	TcMar-Mariner	DNA
Mariner2_DM	TcMar-Tc1	DNA
MarN-1_DEu	TcMar-Mariner	DNA
MarN-2_DEu	TcMar-Tc1	DNA
MARWOLEN1	TcMar-Tc1	DNA
MAX_I	Pao	LTR
MAX_LTR	Pao	LTR
MAX	Pao	LTR
MDG1_I	Gypsy	LTR
MDG1_LTR	Gypsy	LTR
MDG3_I	Gypsy	LTR
MDG3_LTR	Gypsy	LTR
MDG3	Gypsy	LTR
MDG1	Gypsy	LTR
Merlin-1_DF	Merlin	DNA
Merlin-1_DT	Merlin	DNA
Merlin-2_DF	Merlin	DNA
MICROPIA_I	Gypsy	LTR
MICROPIA_LTR	Gypsy	LTR
MICROPIA	Gypsy	LTR
MINIME_DN	MINIME_DN	Non-LTR_retrotransposon
MINOS	TcMar-Tc1	DNA
MuDR-1_DEl	MULE-NOF	DNA
MuDR-1_DF	MULE-NOF	DNA
MuDR-1_DK	MULE-NOF	DNA
MuDR-1_DT	MULE-NOF	DNA
NINJA_I	Pao	LTR
NINJA_LTR	Pao	LTR
NINJA	Pao	LTR
Nobel_I	Pao	LTR
Nobel_LTR	Pao	LTR
Nobel	Pao	LTR
NOF_FB	MULE-NOF	DNA
NOMAD_I	Gypsy	LTR
NOMAD_LTR	Gypsy	LTR
NOMAD	Gypsy	LTR
NTS_DM	IGS	Other
NTS_330_Dmel	IGS	Other
NTS_240_Dmel	IGS	Other
NTS_95_Dmel	IGS	Other
OSVALDO_I	Gypsy	LTR
OSVALDO_LTR	Gypsy	LTR
OSVALDO	Gypsy	LTR
Outcast-1_DAn	Jockey	Non-LTR_retrotransposon
Outcast-1_DBi	Jockey	Non-LTR_retrotransposon
Outcast-1_DBp	Jockey	Non-LTR_retrotransposon
Outcast-1_DEl	Jockey	Non-LTR_retrotransposon
Outcast-1_DEu	Jockey	Non-LTR_retrotransposon
Outcast-1_DT	Jockey	Non-LTR_retrotransposon
Outcast-1_DWi	Jockey	Non-LTR_retrotransposon
Outcast-2_DAn	Jockey	Non-LTR_retrotransposon
Outcast-2_DBp	Jockey	Non-LTR_retrotransposon
P_DB	P	DNA
P_DG	P	DNA
P-1_DBp	P	DNA
P-1_DRh	P	DNA
P-1_DY	P	DNA
P-1N1_DBp	P	DNA
P-2_DRh	P	DNA
P-3_DRh	P	DNA
PARIS	TcMar-Tc1	DNA
PARISa_DAm	TcMar-Tc1	DNA
PARISa_DAn	TcMar-Tc1	DNA
PARISa_DBu	TcMar-Tc1	DNA
PARISa_DEl	TcMar-Tc1	DNA
PARISa_DEq	TcMar-Tc1	DNA
PARISa_DK	TcMar-Tc1	DNA
PARISa_DMo	TcMar-Tc1	DNA
PARISa_DPe	TcMar-Tc1	DNA
PARISa_DPol	TcMar-Tc1	DNA
PARISa_DPs	TcMar-Tc1	DNA
PARISa_DRh	TcMar-Tc1	DNA
PARISa_DSu	TcMar-Tc1	DNA
PARISa-1_DW	TcMar-Tc1	DNA
PARISa-2_DW	TcMar-Tc1	DNA
PARISa-5_DW	TcMar-Tc1	DNA
PENELOPE	Penelope	Non-LTR_retrotransposon
Penelope-1_DEl	Penelope	Non-LTR_retrotransposon
Penelope-1_DF	Penelope	Non-LTR_retrotransposon
Penelope-1_DK	Penelope	Non-LTR_retrotransposon
Penelope-1_DRh	Penelope	Non-LTR_retrotransposon
Penelope1_Dw	Penelope	Non-LTR_retrotransposon
Penelope2_Dw	Penelope	Non-LTR_retrotransposon
Pifo_I	Gypsy	LTR
Pifo_LTR	Gypsy	LTR
Pifo	Gypsy	LTR
piggyBac-1_DAn	PiggyBac	DNA
piggyBac-1_DBi	PiggyBac	DNA
piggyBac-1_DBp	PiggyBac	DNA
piggyBac-1_DEu	PiggyBac	DNA
piggyBac-1_DF	PiggyBac	DNA
piggyBac-1_DW	PiggyBac	DNA
piggyBac-2_DAn	PiggyBac	DNA
piggyBac-2_DBp	PiggyBac	DNA
piggyBac-2_DEu	PiggyBac	DNA
piggyBac-2_DF	PiggyBac	DNA
piggyBac-3_DAn	PiggyBac	DNA
piggyBac-3_DBp	PiggyBac	DNA
piggyBac-3B_DAn	PiggyBac	DNA
piggyBac-N1_DWil	PiggyBac	DNA
PLACW_DM	P	DNA
POGO	TcMar-Pogo	DNA
POGON1	TcMar-Pogo	DNA
Polinton-1_DAn	Maverick	DNA
Polinton-1_DBi	Maverick	DNA
Polinton-1_DBp	Maverick	DNA
Polinton-1_DEl	Maverick	DNA
Polinton-1_DEu	Maverick	DNA
Polinton-1_DGr	Maverick	DNA
Polinton-1_DK	Maverick	DNA
Polinton-1_DPe	Maverick	DNA
Polinton-1_DY	Maverick	DNA
Polinton-2_DBi	Maverick	DNA
Polinton-2_DBp	Maverick	DNA
Polinton-2_DEu	Maverick	DNA
Polinton-2_DK	Maverick	DNA
PROTOP	P	DNA
PROTOP_A	P	DNA
PROTOP_B	P	DNA
QUASIMODO_I	Gypsy	LTR
QUASIMODO_LTR	Gypsy	LTR
QUASIMODO2-I_DM	Gypsy	LTR
QUASIMODO2-LTR_DM	Gypsy	LTR
QUASIMODO2_DM	Gypsy	LTR
QUASIMODO	Gypsy	LTR
R-Rsp_SAT	Rsp	Satellite
R1_DEr	R1	Non-LTR_retrotransposon
R1_DM	R1	Non-LTR_retrotransposon
R1_DMo	R1	Non-LTR_retrotransposon
R1_DPe	R1	Non-LTR_retrotransposon
R1_DPs	R1	Non-LTR_retrotransposon
R1_DSe	R1	Non-LTR_retrotransposon
R1_DSi	R1	Non-LTR_retrotransposon
R1_DVi	R1	Non-LTR_retrotransposon
R1_DWi	R1	Non-LTR_retrotransposon
R1_DYa	R1	Non-LTR_retrotransposon
R1-1_DAn	R1	Non-LTR_retrotransposon
R1-1_DBi	R1	Non-LTR_retrotransposon
R1-1_DBp	R1	Non-LTR_retrotransposon
R1-1_DEl	R1	Non-LTR_retrotransposon
R1-1_DEr	R1	Non-LTR_retrotransposon
R1-1_DEu	R1	Non-LTR_retrotransposon
R1-1_DF	R1	Non-LTR_retrotransposon
R1-1_DGr	R1	Non-LTR_retrotransposon
R1-1_DK	R1	Non-LTR_retrotransposon
R1-1_DPer	R1	Non-LTR_retrotransposon
R1-1_DRh	R1	Non-LTR_retrotransposon
R1-1_DSi	R1	Non-LTR_retrotransposon
R1-1_DT	R1	Non-LTR_retrotransposon
R1-1_DVi	R1	Non-LTR_retrotransposon
R1-1_DYa	R1	Non-LTR_retrotransposon
R1-10_DWi	R1	Non-LTR_retrotransposon
R1-11_DWi	R1	Non-LTR_retrotransposon
R1-12_DWi	R1	Non-LTR_retrotransposon
R1-13_DWi	R1	Non-LTR_retrotransposon
R1-14_DWi	R1	Non-LTR_retrotransposon
R1-15_DWi	R1	Non-LTR_retrotransposon
R1-16_DWi	R1	Non-LTR_retrotransposon
R1-17_DWi	R1	Non-LTR_retrotransposon
R1-18_DWi	R1	Non-LTR_retrotransposon
R1-1B_DK	R1	Non-LTR_retrotransposon
R1-1B_DVi	R1	Non-LTR_retrotransposon
R1-1C_DK	R1	Non-LTR_retrotransposon
R1-2_DAn	R1	Non-LTR_retrotransposon
R1-2_DBi	R1	Non-LTR_retrotransposon
R1-2_DBp	R1	Non-LTR_retrotransposon
R1-2_DEl	R1	Non-LTR_retrotransposon
R1-2_DEu	R1	Non-LTR_retrotransposon
R1-2_DF	R1	Non-LTR_retrotransposon
R1-2_DGr	R1	Non-LTR_retrotransposon
R1-2_DK	R1	Non-LTR_retrotransposon
R1-2_DM	R1	Non-LTR_retrotransposon
R1-2_DPer	R1	Non-LTR_retrotransposon
R1-2_DTa	R1	Non-LTR_retrotransposon
R1-2_DVi	R1	Non-LTR_retrotransposon
R1-2_DWi	R1	Non-LTR_retrotransposon
R1-2_DYa	R1	Non-LTR_retrotransposon
R1-2B_DK	R1	Non-LTR_retrotransposon
R1-3_DAn	R1	Non-LTR_retrotransposon
R1-3_DBp	R1	Non-LTR_retrotransposon
R1-3_DEl	R1	Non-LTR_retrotransposon
R1-3_DEu	R1	Non-LTR_retrotransposon
R1-3_DF	R1	Non-LTR_retrotransposon
R1-3_DK	R1	Non-LTR_retrotransposon
R1-3_DPer	R1	Non-LTR_retrotransposon
R1-3_DVi	R1	Non-LTR_retrotransposon
R1-3_DWi	R1	Non-LTR_retrotransposon
R1-3_DYa	R1	Non-LTR_retrotransposon
R1-3B_DEl	R1	Non-LTR_retrotransposon
R1-4_DAn	R1	Non-LTR_retrotransposon
R1-4_DBp	R1	Non-LTR_retrotransposon
R1-4_DF	R1	Non-LTR_retrotransposon
R1-4_DK	R1	Non-LTR_retrotransposon
R1-4_DPer	R1	Non-LTR_retrotransposon
R1-4_DVi	R1	Non-LTR_retrotransposon
R1-4_DWi	R1	Non-LTR_retrotransposon
R1-4_DYa	R1	Non-LTR_retrotransposon
R1-4B_DK	R1	Non-LTR_retrotransposon
R1-5_DF	R1	Non-LTR_retrotransposon
R1-5_DK	R1	Non-LTR_retrotransposon
R1-5_DPer	R1	Non-LTR_retrotransposon
R1-5_DWi	R1	Non-LTR_retrotransposon
R1-5_DYa	R1	Non-LTR_retrotransposon
R1-5B_DK	R1	Non-LTR_retrotransposon
R1-6_DK	R1	Non-LTR_retrotransposon
R1-6_DPer	R1	Non-LTR_retrotransposon
R1-6_DWi	R1	Non-LTR_retrotransposon
R1-7_DK	R1	Non-LTR_retrotransposon
R1-7_DPer	R1	Non-LTR_retrotransposon
R1-7_DWi	R1	Non-LTR_retrotransposon
R1-8_DWi	R1	Non-LTR_retrotransposon
R1-9_DWi	R1	Non-LTR_retrotransposon
R1A_DAn	R1	Non-LTR_retrotransposon
R1B_DAn	R1	Non-LTR_retrotransposon
R1B_DVi	R1	Non-LTR_retrotransposon
R1B2_DAn	R1	Non-LTR_retrotransposon
R2_DA	R2	Non-LTR_retrotransposon
R2_DAn	R2	Non-LTR_retrotransposon
R2_DM	R2	Non-LTR_retrotransposon
R2_DPe	R2	Non-LTR_retrotransposon
R2_DPs	R2	Non-LTR_retrotransposon
R2_DSe	R2	Non-LTR_retrotransposon
R2_DSi	R2	Non-LTR_retrotransposon
R2_DYa	R2	Non-LTR_retrotransposon
R2-1_DWi	R2	Non-LTR_retrotransposon
R2-2_DWi	R2	Non-LTR_retrotransposon
R2B_DM	R2	Non-LTR_retrotransposon
Rehavkus-1_DA	MULE-NOF	DNA
Rehavkus-1_DY	MULE-NOF	DNA
REP-1_DEl	Other	Other
REP-1_DTa	Other	Other
REP-2_DEl	Other	Other
REP-2_DF	Other	Other
REP-2_DTa	Other	Other
REP-3_DF	Other	Other
ROO_I	Pao	LTR
ROO_LTR	Pao	LTR
ROOA_I	Pao	LTR
ROOA_LTR	Pao	LTR
ROO	Pao	LTR
ROOA	Pao	LTR
ROVER-I_DM	Gypsy	LTR
ROVER-LTR_DM	Gypsy	LTR
ROVER_DM	Gypsy	LTR
RSP-LIKE_SAT	Satellite	Satellite
RTE-1_DAn	RTE-BovB	Non-LTR_retrotransposon
RTE-1_DBi	RTE-BovB	Non-LTR_retrotransposon
RTE-1_DBp	RTE-BovB	Non-LTR_retrotransposon
RTE-1_DF	RTE-BovB	Non-LTR_retrotransposon
RTE-1_DT	RTE-BovB	Non-LTR_retrotransposon
RTE-1_DYa	RTE-BovB	Non-LTR_retrotransposon
RTE-1B_DAn	RTE-BovB	Non-LTR_retrotransposon
RTE-1BN1_DAn	RTE-BovB	Non-LTR_retrotransposon
RTE-1C_DAn	RTE-BovB	Non-LTR_retrotransposon
RTE-2_DAn	RTE-BovB	Non-LTR_retrotransposon
RTE-2_DBp	RTE-BovB	Non-LTR_retrotransposon
RTE-2_DF	RTE-BovB	Non-LTR_retrotransposon
RTE-3_DF	RTE-BovB	Non-LTR_retrotransposon
RTE-4_DF	RTE-BovB	Non-LTR_retrotransposon
RTEX-1_DRh	RTEX	LTR
RTEX-1_DT	RTE-X	Non-LTR_retrotransposon
RTEX-2_DT	RTE-X	Non-LTR_retrotransposon
S_DM	TcMar-Tc1	DNA
S2_DM	TcMar-Tc1	DNA
Sola-1_DK	Sola	DNA
SPOCK_DMi	Jockey	Non-LTR_retrotransposon
Stalker2_I	Gypsy	LTR
Stalker2_LTR	Gypsy	LTR
Stalker3_LTR	Gypsy	LTR
STALKER4_I	Gypsy	LTR
STALKER4_LTR	Gypsy	LTR
Stalker2	Gypsy	LTR
STALKER4	Gypsy	LTR
TABOR_DA-I	Gypsy	LTR
TABOR_DA-LTR	Gypsy	LTR
TABOR_I	Gypsy	LTR
TABOR_LTR	Gypsy	LTR
TABOR	Gypsy	LTR
TAHRE	Jockey	Non-LTR_retrotransposon
TANSAT_DB	Satellite	Satellite
TART_B1	Jockey	Non-LTR_retrotransposon
TART_DV	Jockey	Non-LTR_retrotransposon
TART-1_DWi	Jockey	Non-LTR_retrotransposon
TART-A	Jockey	Non-LTR_retrotransposon
TART-C_NTPR	Jockey	Non-LTR_retrotransposon
TC1_DM	TcMar-Tc1	DNA
TC1-2_DM	TcMar-Tc1	DNA
TIRANT_I	Gypsy	LTR
TIRANT_LTR	Gypsy	LTR
TIRANT	Gypsy	LTR
TLD1	Gypsy	LTR
TLD2	Gypsy	LTR
TOM_I	Gypsy	LTR
TOM_LTR	Gypsy	LTR
TOM	Gypsy	LTR
TRAM_I	Pao	LTR
TRAM_LTR	Pao	LTR
TRAM	Pao	LTR
Transib-1_DAn	CMC-Transib	DNA
Transib-1_DBi	CMC-Transib	DNA
Transib-1_DBp	CMC-Transib	DNA
Transib-1_DEl	CMC-Transib	DNA
Transib-1_DEu	CMC-Transib	DNA
Transib-1_DF	CMC-Transib	DNA
Transib-1_DK	CMC-Transib	DNA
Transib-1_DRh	CMC-Transib	DNA
Transib-10_DAn	CMC-Transib	DNA
Transib-11_DAn	CMC-Transib	DNA
Transib-2_DAn	CMC-Transib	DNA
Transib-2_DBi	CMC-Transib	DNA
Transib-2_DBp	CMC-Transib	DNA
Transib-2_DEl	CMC-Transib	DNA
Transib-2_DF	CMC-Transib	DNA
Transib-2_DK	CMC-Transib	DNA
Transib-2_DRh	CMC-Transib	DNA
Transib-2_DW	CMC-Transib	DNA
Transib-3_DAn	CMC-Transib	DNA
Transib-3_DBi	CMC-Transib	DNA
Transib-3_DBp	CMC-Transib	DNA
Transib-3_DF	CMC-Transib	DNA
Transib-3_DK	CMC-Transib	DNA
Transib-3_DRh	CMC-Transib	DNA
Transib-4_DAn	CMC-Transib	DNA
Transib-4_DBi	CMC-Transib	DNA
Transib-4_DBp	CMC-Transib	DNA
Transib-4_DF	CMC-Transib	DNA
Transib-4_DK	CMC-Transib	DNA
Transib-4_DRh	CMC-Transib	DNA
Transib-5_DAn	CMC-Transib	DNA
Transib-5_DBi	CMC-Transib	DNA
Transib-5_DBp	CMC-Transib	DNA
Transib-5_DK	CMC-Transib	DNA
Transib-5_DRh	CMC-Transib	DNA
Transib-6_DAn	CMC-Transib	DNA
Transib-6_DBi	CMC-Transib	DNA
Transib-6_DBp	CMC-Transib	DNA
Transib-6_DK	CMC-Transib	DNA
Transib-6_DRh	CMC-Transib	DNA
Transib-7_DAn	CMC-Transib	DNA
Transib-7_DBi	CMC-Transib	DNA
Transib-7_DRh	CMC-Transib	DNA
Transib-8_DAn	CMC-Transib	DNA
Transib-8_DRh	CMC-Transib	DNA
Transib-9_DAn	CMC-Transib	DNA
Transib-N1_DM	CMC-Transib	DNA
Transib-N1_DYa	CMC-Transib	DNA
TRANSIB1	CMC-Transib	DNA
Transib1_Dmoj	CMC-Transib	DNA
Transib1_DP	CMC-Transib	DNA
Transib1_Dwil	CMC-Transib	DNA
TRANSIB2	CMC-Transib	DNA
Transib2_DP	CMC-Transib	DNA
TRANSIB3	CMC-Transib	DNA
Transib3_DP	CMC-Transib	DNA
TRANSIB4	CMC-Transib	DNA
Transib4_DP	CMC-Transib	DNA
Transib5	CMC-Transib	DNA
TransibN1_DP	CMC-Transib	DNA
TransibN2_DP	CMC-Transib	DNA
TransibN3_DP	CMC-Transib	DNA
TransibN4_DP	CMC-Transib	DNA
TransibN5_DP	CMC-Transib	DNA
TRANSPAC_I	Gypsy	LTR
TRANSPAC_LTR	Gypsy	LTR
TRANSPAC	Gypsy	LTR
TRIM	LOA	Non-LTR_retrotransposon
TV1I	Gypsy	LTR
TV1LTR	Gypsy	LTR
TV1	Gypsy	LTR
UHU	TcMar-Tc1	DNA
Uhu_DAn	TcMar-Tc1	DNA
Ulysses_I	Gypsy	LTR
Ulysses_LTR	Gypsy	LTR
Ulysses	Gypsy	LTR
UVIR_DV	Jockey	Non-LTR_retrotransposon
VEGE_DW	hAT-Tip100	DNA
WORF_DMi	CR1	Non-LTR_retrotransposon
ZAM_I	Gypsy	LTR
ZAM_LTR	Gypsy	LTR
ZAM	Gypsy	LTR
Zator-1_DF	Zator	DNA
Zator-2_DF	Zator	DNA